240 1 0 0 1 1 2 1 2 3 2 10 8 2 2 22 28 
280 2 2 3 0 1 1 2 0 3 2 5 2 2 3 12 50 
308 1 1 3 2 3 2 1 1 1 1 0 3 2 3 4 28 
276 3 3 0 1 0 2 1 2 1 1 2 1 3 2 3 35 
272 1 2 2 3 3 1 3 3 2 1 5 1 0 2 26 33 
292 0 3 1 3 1 1 0 0 3 0 3 2 1 2 27 25 
252 2 3 2 1 2 2 2 2 3 3 3 3 3 8 31 22 
296 0 3 2 1 1 0 2 3 3 3 2 1 3 0 21 45 
292 0 2 0 3 3 0 2 0 2 3 1 0 2 0 16 34 
272 0 0 2 2 3 0 3 1 0 3 2 5 2 10 26 48 
288 1 0 0 1 2 3 1 1 0 0 1 3 3 2 25 35 
264 0 0 3 3 0 2 0 0 2 2 2 1 3 3 25 20 
272 2 3 0 2 3 3 2 3 3 1 1 1 2 0 10 20 
320 0 1 1 1 2 1 3 1 1 0 0 0 1 0 6 14 
320 2 0 2 3 1 0 0 3 1 1 3 3 3 1 17 34 
260 2 0 2 3 3 1 2 1 2 0 1 12 2 2 22 26 
272 2 3 1 2 1 1 1 0 2 1 13 0 1 1 12 34 
308 0 0 3 1 3 2 3 2 1 1 6 5 3 1 25 17 
260 2 3 0 3 2 1 3 0 2 3 1 2 2 0 14 32 
192 0 2 3 2 3 3 3 0 1 1 2 23 3 8 25 31 
