744 32 32 54 12 28 46 49 42 21 37 49 25 28 37 24 13 
884 0 36 18 10 21 43 36 32 46 63 53 25 1 34 24 8 
844 3 29 14 5 24 50 58 33 39 64 31 32 7 32 29 17 
928 9 19 27 6 24 59 47 21 13 37 49 22 6 15 24 1 
916 0 14 23 17 31 54 39 28 19 61 53 34 3 37 22 26 
876 11 17 21 13 29 42 32 51 38 47 43 31 4 43 32 18 
780 13 28 25 5 48 62 44 26 46 47 60 37 16 51 43 20 
752 33 28 44 2 26 52 38 30 9 49 47 43 16 59 50 2 
868 13 36 16 3 26 62 70 38 28 43 50 32 7 17 35 24 
808 12 25 30 5 12 52 40 42 44 48 45 38 16 21 45 12 
800 5 32 30 3 38 25 48 34 37 64 54 49 29 33 32 5 
872 5 17 36 0 19 46 55 28 37 52 72 34 6 29 28 3 
840 10 31 27 1 32 59 40 31 26 43 42 30 8 42 33 7 
840 10 28 25 7 41 57 50 43 31 52 38 22 16 40 29 10 
816 2 24 23 21 26 34 52 48 30 43 47 40 14 31 33 3 
812 10 38 6 36 33 61 47 21 38 42 40 39 21 41 31 14 
908 12 25 21 3 17 61 53 36 18 53 35 17 3 47 46 16 
768 2 45 37 6 27 45 36 45 37 42 52 31 0 42 23 23 
780 18 49 21 17 35 61 47 39 43 61 42 48 13 51 29 27 
836 3 15 25 13 19 45 42 27 25 44 25 33 3 26 42 18 
