716 33 38 33 43 32 56 26 50 47 32 44 66 63 53 51 54 47 45 53 39 49 55 51 43 47 73 47 55 40 62 65 54 56 48 74 80 49 45 89 73 61 67 68 64 75 92 52 85 62 63 70 85 82 75 82 82 62 75 70 77 65 32 23 22 
728 17 43 35 46 51 55 30 31 31 56 51 72 63 66 26 15 43 59 50 73 58 51 38 36 65 60 56 66 72 61 53 60 42 81 63 76 91 62 76 51 53 84 69 71 68 65 59 70 64 81 68 75 73 70 81 87 64 66 71 88 69 48 23 23 
736 48 40 46 48 45 59 45 45 38 54 53 63 61 66 72 58 44 48 42 58 58 44 42 30 49 52 57 66 86 60 60 53 52 69 73 66 52 78 57 59 56 60 70 72 53 66 65 97 58 72 61 77 78 76 60 98 54 72 74 83 71 43 15 24 
756 35 39 59 22 46 29 46 41 38 53 38 50 37 52 47 38 62 56 53 41 56 43 64 51 53 56 47 65 81 45 35 60 50 59 72 60 72 57 73 72 52 67 81 71 82 77 70 58 75 88 73 87 83 77 82 86 60 61 72 86 85 49 21 18 
732 30 19 49 43 44 52 45 12 48 71 49 50 54 40 52 45 54 39 57 62 75 69 29 40 52 54 51 67 66 56 63 54 56 62 50 66 72 64 81 75 61 69 64 61 74 83 85 55 51 66 67 88 80 72 89 60 66 52 77 85 68 39 23 29 
712 47 50 38 37 52 42 30 23 50 50 46 65 47 60 48 25 43 64 51 62 44 52 47 30 57 60 64 77 70 43 80 61 76 58 57 76 69 75 74 75 69 81 80 63 64 77 72 75 53 71 73 74 85 75 69 82 71 56 67 74 67 34 30 16 
740 42 39 47 39 44 38 34 28 57 59 64 59 58 45 53 17 62 65 74 72 64 57 58 42 58 51 55 56 67 71 42 36 47 50 62 69 59 56 63 81 67 70 69 71 79 78 74 74 61 75 73 73 80 50 72 81 46 55 67 84 66 42 26 25 
784 36 40 25 50 55 45 37 17 51 47 56 49 57 41 60 39 59 41 52 57 66 55 55 54 54 48 70 70 68 54 45 39 52 57 76 76 60 61 45 62 52 72 71 71 77 75 74 66 58 56 74 68 80 77 76 64 61 61 72 78 69 32 11 29 
704 34 49 54 22 44 41 27 39 36 50 39 57 27 54 57 38 50 48 62 61 52 58 62 58 48 57 57 65 90 63 74 63 59 66 67 72 65 67 82 55 70 69 60 70 77 74 71 66 55 69 60 79 76 82 72 66 66 56 62 73 72 43 19 21 
680 39 32 42 35 39 49 29 27 65 48 53 57 55 42 23 29 57 57 54 67 85 68 64 54 56 48 54 55 78 55 73 45 39 76 80 81 60 62 62 71 56 67 59 83 64 82 74 61 50 67 70 64 88 85 69 86 49 66 75 72 73 41 31 34 
728 47 44 27 34 31 38 37 44 52 42 47 57 61 67 65 32 28 55 70 62 54 63 67 79 56 62 54 71 56 29 62 33 58 64 75 78 55 73 81 32 62 68 81 81 78 70 79 82 62 61 56 68 67 70 73 74 55 62 75 74 59 45 21 31 
844 33 34 33 49 31 36 28 56 32 43 41 54 59 54 38 32 32 45 75 79 66 57 48 36 56 53 74 67 68 52 60 56 54 74 63 72 63 79 77 68 58 82 57 71 74 64 51 67 62 75 75 74 92 68 80 80 65 65 65 74 73 40 23 30 
748 32 38 34 47 34 39 43 9 39 52 41 45 49 39 48 21 49 54 61 38 59 63 63 48 40 66 59 60 46 69 63 41 52 59 68 66 51 52 86 79 60 63 79 73 68 68 71 66 53 75 84 72 80 74 77 81 60 72 69 67 74 32 22 28 
700 34 39 38 48 29 37 33 29 48 68 59 40 51 44 33 42 38 53 57 73 39 60 55 57 49 69 62 65 74 56 56 65 60 63 62 67 68 62 54 60 53 80 68 71 77 74 79 61 54 61 64 69 74 84 78 65 54 79 69 69 65 33 17 20 
812 38 48 37 31 32 40 49 27 44 49 49 43 64 56 42 39 63 55 59 53 73 45 69 46 58 68 45 50 65 58 49 36 59 61 49 76 80 60 68 27 66 63 67 75 70 89 59 68 65 68 82 65 77 84 61 78 55 76 73 73 58 46 24 31 
720 31 38 64 38 46 42 38 37 45 59 60 59 49 53 52 35 65 57 56 49 60 49 54 46 56 69 50 64 70 56 50 39 61 68 72 76 68 56 71 75 66 60 64 71 67 77 79 66 68 76 64 74 75 81 81 80 51 71 71 76 70 39 25 32 
668 51 36 46 46 69 56 38 18 60 63 54 77 49 64 32 45 50 47 65 57 67 49 69 49 64 77 72 61 68 65 61 57 49 80 72 52 59 79 59 65 42 76 59 71 74 80 66 66 55 79 82 73 83 61 57 76 55 52 77 71 78 44 20 22 
700 43 41 52 39 41 51 43 33 49 64 61 57 36 54 39 43 66 59 61 57 52 48 55 53 49 72 59 62 60 71 60 66 63 53 61 63 52 62 84 51 68 54 70 77 82 75 61 66 64 70 69 71 71 77 68 76 67 64 68 85 69 56 14 19 
712 54 37 38 31 32 38 38 32 48 58 37 42 48 54 48 20 43 72 67 74 55 55 46 28 54 54 68 65 79 46 65 48 53 74 63 51 62 68 83 61 68 54 78 65 73 73 73 58 68 72 67 70 78 75 80 84 62 75 75 77 77 41 19 20 
748 31 37 50 38 44 50 32 20 39 48 38 52 46 50 44 37 40 42 53 49 54 62 42 59 58 55 64 58 73 61 66 59 47 57 56 62 79 58 65 70 62 72 68 65 79 73 61 90 62 56 55 82 81 86 87 84 53 63 71 68 64 33 21 16 
