968 3 1 0 3 2 3 3 3 2 3 2 2 3 1 0 3 
932 3 0 0 0 1 2 1 3 2 3 1 2 3 3 2 3 
944 2 2 2 3 0 0 2 3 0 0 1 3 3 2 3 0 
948 1 0 3 0 3 1 3 2 1 3 2 3 2 1 3 1 
920 1 1 1 0 0 2 2 3 3 3 2 3 1 2 3 1 
908 1 3 3 3 0 1 1 0 3 2 0 1 3 0 3 3 
952 0 2 3 2 2 3 3 2 3 1 0 1 3 1 1 3 
884 2 3 0 2 2 0 2 1 2 0 2 2 3 2 0 0 
912 0 2 3 3 0 0 1 1 3 3 1 3 3 2 3 2 
968 0 0 2 2 1 3 2 2 3 3 3 3 0 2 1 2 
940 0 0 1 1 3 1 1 1 3 1 3 1 3 1 0 2 
900 2 0 3 1 2 3 0 1 1 2 3 3 0 2 2 1 
924 0 2 2 2 0 2 1 2 3 1 2 3 3 0 0 2 
960 2 2 3 2 2 1 1 0 3 0 0 0 0 1 3 1 
988 1 1 0 1 1 1 0 0 2 1 1 1 1 3 2 3 
940 1 2 3 1 1 3 2 3 1 0 3 3 3 3 2 1 
588 10 12 34 18 15 28 35 28 26 40 23 23 8 23 18 13 
936 0 1 0 2 1 0 2 1 3 3 1 3 1 0 2 2 
952 1 2 2 2 0 1 3 3 0 2 0 2 1 0 3 0 
936 2 3 0 0 1 2 2 0 1 3 1 2 2 0 3 2 
