251 56 74 31 56 88 78 83 50 77 91 84 63 100 86 81 31 
214 83 74 81 63 71 98 82 68 85 92 88 52 86 94 79 31 
254 61 87 50 31 83 95 73 82 76 89 87 54 74 76 83 26 
168 89 75 70 58 95 89 74 73 96 83 87 62 72 85 84 30 
220 63 73 62 68 77 101 79 63 79 84 89 62 86 80 80 46 
242 58 74 62 51 81 82 86 70 90 93 91 53 76 82 73 28 
223 61 80 75 55 75 89 87 68 83 91 94 74 68 86 78 41 
177 70 80 61 31 83 87 69 75 97 94 97 81 82 85 84 42 
219 65 67 69 41 71 87 73 72 72 82 86 70 75 94 74 39 
227 72 66 69 47 89 80 76 76 74 76 86 63 76 89 81 42 
