427 62 38 70 78 51 50 65 70 65 73 73 78 73 58 71 45 
418 44 59 68 71 67 66 67 72 54 81 35 65 75 57 60 58 
425 49 80 53 75 57 57 75 62 43 73 40 56 74 55 55 57 
397 40 69 53 89 79 78 82 56 65 68 44 90 85 48 66 60 
440 56 73 54 81 56 40 74 68 58 91 51 63 79 39 63 48 
413 35 61 68 68 51 59 64 62 63 78 44 51 73 56 66 60 
439 52 65 58 67 68 53 66 51 55 76 54 71 61 60 67 47 
391 60 62 76 81 74 50 73 63 71 85 48 75 78 55 69 41 
446 54 48 51 86 60 41 82 60 38 70 51 77 86 60 76 59 
463 42 57 63 68 49 60 81 56 61 68 38 55 72 72 62 48 
