293 47 84 73 52 61 59 58 71 71 65 70 83 64 91 66 42 56 74 63 67 86 69 49 61 61 82 99 98 78 73 57 62 42 83 92 94 85 86 41 61 77 69 89 82 80 72 81 42 69 67 82 79 82 60 62 42 42 57 78 85 63 47 24 3 
355 53 57 65 71 57 63 62 37 64 70 63 61 88 67 72 46 58 82 76 80 77 53 56 66 67 72 88 86 88 77 76 54 63 85 68 81 89 81 66 64 60 78 72 69 68 60 74 53 64 55 62 59 48 74 55 47 40 70 68 73 61 63 28 6 
386 56 49 57 44 54 57 58 45 72 67 65 83 73 63 52 68 72 66 74 89 92 76 65 40 80 90 95 99 83 80 79 64 69 74 80 87 80 89 82 44 81 57 71 90 79 80 67 41 64 72 74 70 62 35 61 42 62 66 73 83 72 52 16 6 
408 59 62 60 67 54 57 60 46 51 72 79 76 73 69 64 62 56 62 69 76 80 68 67 49 73 75 72 84 78 74 62 66 78 77 73 94 82 86 61 44 73 77 66 84 76 66 65 61 53 78 80 69 70 76 74 59 56 49 72 64 59 47 19 1 
375 62 68 47 56 59 57 67 55 52 68 88 81 77 53 71 33 79 76 96 79 81 77 72 51 57 71 66 88 78 70 63 44 69 71 68 73 87 76 59 68 48 58 78 80 84 78 62 49 73 72 81 79 64 77 60 50 45 51 61 70 74 68 29 2 
462 46 71 75 52 63 54 51 44 60 90 74 69 73 82 50 59 86 59 76 71 73 77 62 55 69 64 81 86 84 76 73 40 73 85 87 94 96 73 61 69 58 60 83 88 82 79 65 49 47 72 71 76 66 67 49 49 48 71 66 64 57 70 25 5 
432 72 66 68 53 53 58 57 30 63 74 61 68 74 73 53 50 75 74 72 73 83 73 67 65 78 78 87 82 80 74 79 54 74 77 83 84 88 85 73 57 38 78 72 86 76 58 56 68 54 74 58 69 75 63 49 56 37 61 76 75 64 68 32 3 
357 48 69 55 79 59 70 56 45 53 63 78 71 74 80 71 51 60 71 73 86 92 96 65 65 67 79 85 94 75 81 68 66 48 70 76 77 79 84 56 44 69 68 74 76 96 73 69 58 62 58 61 67 80 55 56 46 58 74 81 64 60 61 38 0 
336 55 73 72 78 67 66 50 61 54 62 61 80 64 68 50 69 61 75 102 83 89 60 64 40 61 83 79 85 87 73 83 60 63 74 86 78 87 79 70 60 58 85 77 84 87 79 48 51 45 66 73 73 65 66 64 55 54 74 69 69 78 73 18 2 
499 33 66 58 80 73 57 54 24 66 53 68 94 77 58 62 57 52 65 70 86 77 75 62 55 60 72 67 95 75 79 56 47 71 68 70 86 96 78 75 64 79 81 68 81 75 73 51 59 53 60 73 79 59 67 63 59 59 56 70 50 64 67 11 0 
