1420 1 3 2 3 0 2 2 3 3 2 3 3 3 3 1 3 
1388 1 3 1 0 0 3 2 3 3 3 2 1 0 3 0 3 
1336 2 2 0 2 0 0 0 2 3 3 2 1 1 0 0 3 
1276 1 3 1 3 2 1 3 1 1 0 3 1 1 1 1 1 
1404 1 3 0 2 0 1 1 1 2 0 3 0 2 3 2 2 
1344 1 2 2 3 1 0 2 3 2 1 0 0 0 0 2 3 
1364 1 3 0 3 3 3 2 1 0 2 3 2 1 2 0 3 
1344 0 2 0 3 1 3 1 1 0 3 1 2 3 1 0 1 
1348 2 1 2 0 2 2 0 3 0 0 3 1 0 0 1 0 
1372 0 3 0 0 2 2 2 1 0 1 2 3 3 2 1 3 
1380 1 0 1 2 1 1 3 3 1 1 0 3 2 3 0 0 
1336 1 2 1 3 3 0 3 2 1 3 2 3 2 2 3 2 
1352 1 0 3 2 2 0 3 0 1 3 3 2 2 2 1 1 
1344 2 2 2 0 0 3 2 2 3 3 3 0 0 1 2 3 
1392 1 2 3 0 1 1 3 0 3 0 0 3 1 0 2 2 
1360 3 2 0 2 2 3 1 1 0 0 1 2 1 3 2 1 
1364 1 1 1 2 2 0 1 1 1 2 2 2 1 3 1 0 
1316 0 2 2 2 0 1 0 2 2 0 0 3 0 2 1 2 
1408 0 3 3 0 3 3 0 0 1 2 3 0 3 3 2 3 
1364 2 3 3 1 1 1 2 1 1 2 2 2 2 1 0 0 
1368 3 3 3 1 0 2 2 2 1 3 1 3 3 3 3 2 
1360 1 0 1 0 2 3 1 3 3 3 2 1 1 2 1 2 
1352 3 1 0 3 2 2 1 3 0 0 0 0 3 0 0 2 
1360 3 3 1 0 2 0 0 0 2 1 2 1 0 0 1 1 
1360 0 1 2 2 2 0 0 3 3 3 3 1 3 2 3 2 
1376 1 2 3 3 3 3 2 0 3 0 3 0 0 0 1 2 
1348 2 2 0 0 2 2 3 0 2 3 3 3 2 1 0 1 
1348 1 2 0 2 0 1 0 3 2 3 3 2 1 0 2 0 
1368 3 3 1 1 0 2 1 3 2 3 3 3 1 2 3 2 
1344 1 0 1 3 1 2 2 3 3 3 3 1 2 1 3 1 
1396 3 3 2 3 0 0 0 2 1 2 3 0 2 3 0 0 
1388 3 0 3 3 3 1 3 3 0 2 3 1 1 3 2 0 
1352 2 3 2 3 2 3 0 1 0 1 0 1 1 3 0 1 
1348 1 1 3 3 2 3 1 0 1 0 1 3 2 2 3 3 
1384 0 1 3 1 1 2 2 3 2 0 3 1 2 0 2 0 
1336 0 3 3 0 0 0 0 2 1 3 3 1 0 3 1 3 
1396 2 0 0 3 1 3 3 2 2 0 0 2 1 3 2 3 
1372 0 2 1 0 3 1 0 1 3 3 1 0 2 0 2 2 
1360 0 2 3 1 2 0 0 0 2 2 0 3 0 1 2 0 
1348 1 1 0 0 1 2 2 0 3 3 0 2 0 2 1 2 
