1548 1 3 3 2 2 0 3 1 1 3 0 1 2 1 2 2 
1636 3 2 1 0 2 2 0 3 2 0 2 2 0 3 3 3 
1636 2 3 3 1 2 1 1 3 0 2 1 0 3 2 3 3 
1596 1 3 2 0 2 2 1 3 3 0 2 2 2 1 1 2 
1600 3 1 0 1 3 2 3 3 2 1 2 1 1 3 1 0 
1568 0 1 1 3 2 3 2 3 0 1 0 0 1 0 1 0 
1604 1 0 1 0 3 1 2 1 3 2 3 1 2 2 2 1 
1552 2 0 3 0 2 0 2 0 1 0 3 0 3 1 3 0 
1620 1 2 0 3 2 0 0 3 0 3 2 2 1 3 1 1 
1584 0 3 2 3 2 2 3 1 1 3 1 1 3 3 2 2 
1608 1 2 1 0 2 2 3 1 0 0 3 3 2 1 2 3 
1596 3 3 2 3 3 2 3 2 2 0 0 0 2 0 1 1 
1552 1 1 1 1 0 1 3 3 3 3 2 2 3 0 1 0 
1580 0 1 2 0 0 2 2 1 3 3 0 0 1 3 3 2 
1572 1 2 3 2 3 2 3 0 0 1 0 0 3 2 2 3 
1560 0 2 2 3 0 0 3 1 3 3 1 3 0 1 3 1 
1608 3 1 1 3 3 1 1 2 0 1 1 2 0 3 0 2 
1620 1 3 2 2 1 1 0 2 3 2 1 1 2 3 3 2 
1608 1 2 1 3 3 2 1 1 3 0 1 0 3 1 0 0 
1608 0 3 2 1 1 1 1 1 1 3 1 0 0 2 0 2 
1608 1 1 2 3 1 3 2 1 0 0 0 2 0 1 2 0 
1588 1 2 0 2 3 1 3 1 1 0 2 1 3 3 2 0 
1636 1 2 2 2 1 0 0 3 2 0 1 2 3 2 3 3 
1580 3 0 1 3 2 1 2 2 2 3 1 1 0 1 0 1 
1588 0 0 1 0 1 3 2 1 3 2 0 3 1 3 0 1 
1588 2 0 2 3 0 2 2 3 2 0 0 3 1 0 3 1 
1532 1 2 0 3 1 1 0 3 0 3 1 0 1 1 3 3 
1588 1 2 2 3 1 1 1 3 3 3 3 2 2 1 2 0 
1592 3 1 1 1 2 0 2 0 3 1 1 3 3 3 2 1 
1544 2 0 3 2 2 1 3 0 2 2 0 0 0 0 0 0 
1580 1 3 0 3 1 3 0 0 1 1 0 2 2 2 1 1 
1628 3 0 3 2 1 1 0 2 0 0 0 2 2 0 2 3 
1576 1 1 0 0 2 2 3 1 2 2 1 0 1 1 0 0 
1564 1 0 2 0 3 2 2 1 2 0 2 2 0 0 2 2 
1556 3 1 1 2 3 1 0 2 3 2 2 2 0 2 3 2 
1620 3 3 3 3 1 1 3 1 2 1 0 1 1 0 0 3 
1588 1 0 2 2 3 1 1 3 2 0 0 0 2 3 3 3 
1556 0 2 2 2 0 0 2 1 3 0 1 0 0 2 3 2 
1604 3 1 1 1 3 0 0 0 2 0 2 1 2 2 0 3 
1564 3 1 3 0 0 0 2 3 0 3 3 1 1 2 3 2 
