444 0 2 3 2 
452 1 1 3 0 
460 1 2 3 1 
448 1 0 1 1 
480 0 2 3 2 
436 2 3 0 1 
468 2 3 3 0 
464 2 3 3 1 
444 2 2 3 3 
448 2 1 2 0 
468 3 3 1 2 
472 1 3 2 3 
472 2 0 2 1 
420 3 3 3 2 
460 0 1 3 2 
444 0 0 0 0 
444 3 3 2 0 
424 3 2 2 3 
460 1 0 2 3 
448 3 1 2 1 
452 1 3 2 3 
472 0 1 0 2 
428 3 0 1 0 
480 1 1 2 0 
464 1 1 0 2 
432 3 0 1 1 
444 1 1 3 0 
460 1 1 1 2 
464 3 1 3 1 
452 3 2 1 3 
480 2 2 3 0 
456 2 1 0 1 
472 1 1 1 1 
476 3 0 2 3 
440 0 0 3 2 
476 1 2 0 2 
452 1 0 3 3 
492 3 0 3 0 
448 0 0 1 0 
440 1 0 1 1 
