604 0 0 0 0 32 40 57 53 56 30 69 58 43 66 60 53 32 58 43 57 
644 0 0 0 0 32 52 63 58 37 37 62 36 44 37 51 47 35 53 57 53 
572 0 0 0 0 66 55 48 42 46 45 56 56 47 62 42 46 48 60 53 42 
688 0 0 0 0 58 58 41 45 49 46 50 31 45 41 74 43 33 47 28 35 
640 0 0 0 0 59 40 55 53 54 45 44 38 47 55 47 40 63 54 50 44 
556 0 0 0 0 50 63 78 58 30 44 41 47 52 41 55 40 47 42 58 75 
620 0 0 0 0 57 49 64 45 67 47 64 59 39 46 56 52 32 42 63 73 
648 0 0 0 0 31 34 31 49 53 46 60 59 30 51 53 38 37 43 50 53 
660 0 0 0 0 55 53 46 43 45 21 32 56 18 55 56 51 53 55 55 37 
608 0 0 0 0 52 45 54 57 63 50 54 52 58 44 37 37 59 43 60 51 
668 0 0 0 0 52 45 31 45 28 41 55 37 43 34 39 37 59 66 61 28 
592 0 0 0 0 35 41 35 56 47 44 57 47 48 56 35 31 66 49 48 56 
676 0 0 0 0 37 37 58 37 48 57 57 62 40 35 32 36 41 57 49 51 
604 0 0 0 0 27 52 60 53 56 51 60 58 41 19 42 46 50 51 54 58 
656 0 0 0 0 53 45 43 51 44 41 60 45 44 42 43 37 34 46 45 28 
540 0 0 0 0 61 37 51 57 59 53 54 68 34 65 60 49 59 40 29 72 
644 0 0 0 0 42 23 42 37 45 41 45 44 52 41 51 60 64 56 56 51 
684 0 0 0 0 47 39 46 41 50 42 62 50 42 52 48 47 45 55 40 22 
600 0 0 0 0 51 52 33 54 30 50 30 28 73 45 59 72 48 49 65 56 
656 0 0 0 0 37 53 39 52 45 41 35 47 53 55 51 40 41 48 50 34 
