52 0 184 156 144 168 2 1 0 3 1 3 3 0 3 0 2 0 3 2 3 3 
32 0 140 124 128 128 3 3 3 3 0 0 3 2 0 2 3 0 2 1 2 1 
52 0 132 136 116 144 3 0 3 1 0 2 1 3 0 3 0 2 3 3 1 3 
48 0 168 148 136 128 0 0 2 2 1 2 3 3 1 2 3 2 1 2 0 1 
32 0 172 156 156 152 3 0 0 3 2 3 0 1 0 0 3 1 2 2 2 1 
44 0 136 172 160 136 0 3 2 1 1 0 0 0 3 2 3 1 1 1 0 1 
48 0 156 172 172 116 2 2 1 1 1 2 1 0 3 1 2 2 3 2 3 2 
44 0 144 180 152 136 0 0 1 1 0 3 0 0 1 2 3 0 3 0 0 0 
32 0 148 172 156 144 0 1 0 1 0 1 2 1 2 0 0 2 0 1 0 3 
52 0 144 160 160 152 0 1 2 1 1 3 3 3 2 1 3 0 2 3 2 1 
28 0 140 176 172 160 2 2 1 0 1 1 2 1 1 3 2 2 3 2 3 3 
44 0 124 136 144 140 0 1 3 0 3 1 3 0 0 1 0 0 1 3 0 0 
40 0 120 164 136 168 3 0 2 1 1 1 2 0 0 1 2 3 2 2 3 1 
36 0 136 164 148 144 1 2 2 0 3 0 3 1 3 1 2 0 0 3 0 2 
44 0 176 160 136 140 0 0 1 1 2 1 0 0 0 2 3 2 1 2 3 0 
48 0 164 144 116 116 2 1 1 0 2 3 3 0 1 0 3 2 2 2 3 3 
60 0 148 132 176 168 2 0 1 0 3 0 3 1 2 3 1 2 3 1 0 1 
32 0 172 156 184 164 2 2 0 0 2 2 3 1 3 1 3 0 0 1 2 3 
40 0 160 148 152 152 0 0 2 3 2 0 2 3 2 2 3 2 2 0 1 3 
28 0 152 136 148 144 3 1 1 3 0 3 3 0 1 3 0 0 1 0 2 2 
