1372 28 20 24 20 2 0 1 4 1 2 1 3 3 1 2 0 0 1 0 2 
1372 4 12 0 44 3 3 0 3 3 1 1 3 2 0 1 0 0 1 2 0 
1412 0 0 0 12 2 1 0 3 1 3 3 0 0 2 3 2 3 3 4 2 
1364 0 12 0 24 3 1 3 2 3 2 0 2 2 4 1 0 2 1 2 3 
1360 4 8 0 4 2 2 1 3 1 0 3 2 2 3 1 2 2 2 2 1 
1376 0 0 12 0 1 0 3 2 0 2 3 1 0 2 2 1 3 1 2 3 
1332 0 0 16 20 3 0 0 3 0 3 3 0 2 2 3 1 2 2 1 1 
1352 12 8 12 20 1 2 3 2 3 3 3 2 3 1 0 0 3 2 2 2 
1348 28 8 12 24 2 4 0 3 0 3 0 3 2 1 3 3 4 1 1 0 
1368 0 4 0 4 6 2 6 2 0 1 2 3 3 3 3 2 0 1 2 1 
1396 8 0 4 0 0 3 3 0 2 3 3 0 3 1 1 2 1 1 2 1 
1324 16 16 16 12 3 0 0 3 1 2 0 3 0 1 3 0 1 0 1 0 
1364 4 4 0 8 2 3 2 0 0 3 2 3 3 2 2 2 2 3 3 2 
1388 0 0 0 0 1 2 1 1 1 2 1 3 2 3 1 3 1 3 0 1 
1388 0 4 4 4 0 2 3 3 5 2 2 0 2 1 2 0 4 3 1 1 
1380 12 24 20 20 0 0 1 2 3 0 0 2 1 2 0 1 2 0 1 2 
1352 0 4 0 32 2 3 2 2 0 1 2 1 2 0 2 2 3 1 2 3 
1336 8 0 0 20 0 2 3 0 0 0 3 3 3 2 0 0 3 3 0 3 
1388 0 4 0 0 0 3 0 1 3 2 3 1 2 1 3 3 2 1 2 2 
1384 4 0 0 8 1 3 1 2 2 0 2 6 2 2 2 0 0 3 0 1 
