1352 0 0 8 0 3 3 3 2 3 2 3 1 0 2 2 0 1 2 3 2 
1356 0 12 8 8 1 2 0 1 0 3 1 1 0 0 2 0 0 1 1 3 
1384 8 16 12 24 0 2 0 2 0 3 0 2 2 0 2 0 2 4 3 1 
1364 0 20 8 20 0 3 0 3 1 3 2 1 1 3 3 0 2 1 1 0 
1408 0 8 12 20 1 3 2 2 1 1 2 1 3 6 1 2 3 1 1 2 
1372 0 12 16 32 2 2 2 1 2 1 4 1 1 0 0 1 2 1 2 3 
1372 12 16 12 8 3 0 0 0 1 3 1 2 0 2 1 1 2 2 2 3 
1344 0 32 24 32 1 2 1 3 2 3 1 2 1 2 2 3 1 2 2 0 
1416 4 0 0 16 1 2 2 0 3 2 0 0 3 0 0 0 2 1 2 2 
1340 12 0 0 12 2 2 3 0 3 1 2 3 2 0 3 3 0 3 3 0 
1376 0 4 0 12 1 3 3 2 2 2 1 3 2 2 0 0 0 1 1 2 
1348 32 16 20 20 2 2 2 3 3 2 1 3 1 1 2 1 0 3 2 0 
1368 0 0 12 8 0 1 3 2 2 2 2 2 3 1 1 1 3 1 1 1 
1344 0 16 16 12 0 1 2 2 2 0 1 5 3 1 0 3 3 1 3 2 
1396 0 24 16 0 2 2 2 1 0 2 1 3 3 1 1 0 1 1 3 0 
1420 16 0 0 4 0 0 0 2 2 3 1 2 3 1 2 2 1 2 2 2 
1400 16 28 16 16 1 0 2 2 1 2 3 1 1 1 2 1 1 2 1 0 
1388 0 0 4 0 0 3 2 2 1 3 2 3 3 3 2 1 4 0 2 1 
1400 0 8 4 52 0 1 3 1 0 1 2 3 2 2 0 2 1 1 3 2 
1404 0 0 0 0 0 2 2 3 3 1 0 0 0 4 1 0 3 1 4 3 
