616 0 0 0 0 49 48 31 43 40 45 45 48 63 31 50 49 57 44 32 59 
608 0 0 0 0 30 61 56 41 37 48 42 51 60 51 26 59 48 55 51 57 
548 0 0 0 0 53 63 49 39 42 63 44 72 58 34 51 55 44 62 45 61 
572 0 0 0 0 51 69 61 60 45 30 29 56 60 77 42 55 54 36 53 41 
608 0 0 0 0 31 51 51 65 43 51 58 65 49 56 56 56 39 39 31 44 
660 0 0 0 0 45 25 53 44 43 65 46 29 30 59 61 48 43 44 61 54 
636 0 0 0 0 28 32 60 43 55 58 72 56 38 52 50 58 42 42 47 53 
616 0 0 0 0 61 41 25 37 35 47 35 42 36 45 41 59 40 59 70 36 
632 0 0 0 0 44 50 36 43 70 64 48 50 72 56 41 55 42 32 42 14 
584 0 0 0 0 40 51 65 41 39 42 54 44 61 63 53 48 38 55 62 58 
616 0 0 0 0 54 59 68 48 49 42 62 38 56 34 44 35 50 61 60 67 
636 0 0 0 0 33 37 49 57 43 70 42 56 33 55 42 40 71 62 39 54 
608 0 0 0 0 43 41 27 53 30 48 36 53 46 57 47 60 50 42 65 63 
704 0 0 0 0 22 34 39 34 44 48 52 28 59 57 27 58 58 54 37 64 
664 0 0 0 0 29 35 57 44 27 51 49 37 45 50 45 50 43 60 36 33 
776 0 0 0 0 37 33 42 38 20 35 39 41 53 40 44 38 41 44 42 41 
644 0 0 0 0 46 39 41 53 67 29 45 50 61 36 39 47 35 64 53 41 
568 0 0 0 0 46 41 66 62 55 51 65 56 57 34 19 39 59 50 62 37 
636 0 0 0 0 41 34 45 42 38 53 51 30 45 49 44 49 45 55 42 60 
624 128 108 180 196 1 0 0 1 1 1 0 2 2 2 0 0 0 1 2 2 
