452 2 2 0 0 
456 2 0 1 3 
464 0 3 2 1 
424 3 1 0 3 
436 3 1 1 1 
460 1 0 3 2 
456 1 1 2 2 
448 1 1 0 0 
448 3 2 1 0 
460 0 3 2 1 
428 3 1 1 2 
464 3 0 1 1 
460 3 0 1 2 
456 1 3 3 1 
440 2 0 1 1 
436 2 0 2 2 
448 0 0 0 1 
464 2 1 3 0 
492 0 2 0 2 
476 0 0 3 1 
