408 940 0 0 0 0 2 1 4 0 3 0 0 2 3 2 1 3 0 3 1 3 
408 924 4 0 0 0 3 2 2 3 2 2 1 0 3 1 1 0 2 0 0 1 
408 912 0 0 0 0 2 3 2 3 3 1 2 0 1 1 1 3 1 0 1 2 
408 916 0 0 0 0 3 0 3 2 0 2 1 0 3 0 0 0 2 3 3 3 
408 880 0 0 0 0 3 0 0 1 3 2 2 2 2 2 1 0 1 2 1 2 
408 924 0 0 0 0 1 2 3 2 3 3 0 0 3 3 3 3 2 0 2 0 
408 924 0 0 0 0 2 1 3 3 2 2 2 3 2 0 0 3 0 0 3 0 
408 952 0 0 0 0 1 1 3 3 0 0 3 1 0 3 2 0 3 0 3 3 
408 896 0 0 0 0 3 1 0 3 1 1 0 3 3 2 3 0 2 3 2 2 
408 896 0 0 0 0 2 1 2 3 3 1 3 3 1 2 3 3 2 0 0 1 
408 936 0 0 0 0 1 3 3 1 1 2 2 0 0 3 1 2 0 0 0 2 
408 948 0 0 0 0 2 1 3 1 3 3 0 0 0 2 0 0 1 1 2 0 
408 912 0 0 0 0 0 2 2 0 3 3 3 3 3 2 0 3 1 1 0 1 
408 936 0 0 0 4 2 0 2 1 3 3 0 2 0 1 2 2 3 0 1 3 
408 924 0 0 0 0 1 2 2 3 2 3 3 0 3 4 0 1 3 3 0 0 
408 936 0 0 0 0 1 1 1 2 0 0 0 0 1 0 3 1 3 1 2 1 
408 892 0 0 0 0 2 0 0 3 0 3 1 0 2 3 1 1 1 3 1 2 
408 924 0 0 0 0 2 1 0 1 3 1 2 3 2 1 0 3 2 2 1 2 
408 920 0 4 8 0 1 2 2 1 1 1 3 1 1 0 0 2 2 3 0 0 
408 912 0 0 0 0 0 1 0 3 3 0 0 1 2 1 3 2 2 3 2 0 
