1520 28 40 16 16 3 0 2 2 1 1 1 2 2 1 0 3 0 3 3 1 
1484 4 0 20 8 1 1 1 1 3 2 1 3 2 1 2 2 3 3 3 2 
1508 40 16 20 32 0 3 1 2 2 2 3 2 1 1 0 3 0 1 1 0 
1516 28 20 32 20 1 0 1 0 0 3 1 3 1 1 3 0 0 2 1 3 
1488 20 8 0 36 2 1 1 2 3 0 0 0 0 3 0 1 1 1 0 2 
1500 16 16 24 28 0 3 3 0 0 1 1 2 2 1 2 0 2 0 1 1 
1496 8 20 36 28 2 3 2 1 1 0 1 0 3 0 0 0 1 1 1 2 
1500 20 28 36 28 2 2 2 1 0 0 2 2 3 2 0 1 2 2 0 2 
1516 8 36 12 36 0 1 3 0 3 3 2 1 0 1 3 1 1 2 0 1 
1492 16 12 0 32 3 0 2 0 3 0 3 3 0 1 1 1 3 1 0 1 
1496 20 4 24 60 3 3 3 0 3 0 0 1 3 1 3 2 3 1 3 0 
1496 16 0 28 28 1 0 2 1 0 0 0 1 0 1 3 1 1 0 3 3 
1500 28 20 24 40 1 1 1 4 0 3 3 0 2 3 2 1 2 0 0 0 
1496 12 28 16 24 3 2 3 3 2 1 1 3 2 1 0 3 1 2 1 0 
1504 40 32 20 0 1 2 2 3 1 1 0 3 3 2 1 2 1 1 1 2 
1496 12 36 16 12 0 1 1 0 1 0 2 2 2 1 2 1 1 1 2 1 
1488 0 16 4 16 0 0 1 0 0 2 3 3 1 2 1 1 2 1 0 0 
1476 20 8 0 32 3 1 0 0 1 2 0 3 3 2 0 3 0 1 3 3 
1500 16 4 28 32 0 2 1 3 1 0 1 2 0 0 3 1 2 0 3 2 
1516 48 36 8 36 1 1 0 0 3 3 3 0 1 0 0 0 2 1 1 2 
