48 0 152 140 160 140 3 2 2 1 1 1 3 0 3 0 2 3 2 0 2 1 
32 0 184 168 132 144 0 1 1 3 0 1 1 1 0 1 2 1 1 1 3 3 
60 0 160 148 144 144 1 2 0 2 0 2 0 0 1 1 2 3 1 0 2 2 
40 0 168 156 164 140 3 2 2 3 1 0 2 3 0 0 3 3 0 0 2 2 
28 0 160 168 136 180 2 1 2 3 1 3 3 1 0 1 3 1 0 2 0 0 
36 0 136 152 152 152 1 0 3 0 3 1 2 3 1 2 3 2 2 0 0 2 
36 0 152 140 164 160 0 1 1 1 3 2 1 2 0 2 3 1 2 2 0 0 
32 0 160 140 136 156 3 2 1 0 3 2 2 1 0 1 3 1 0 0 2 0 
40 0 156 140 172 148 3 2 3 3 3 2 1 3 3 0 3 3 3 3 0 0 
48 0 160 132 140 120 1 2 2 3 1 2 0 2 0 3 3 2 3 1 0 1 
60 0 144 164 144 168 2 2 3 1 3 0 0 2 3 2 3 0 2 3 0 0 
24 0 164 152 184 200 0 1 3 2 1 3 1 3 2 1 3 1 0 1 1 2 
52 0 136 164 160 168 0 2 3 3 0 3 0 3 0 3 2 1 3 0 0 2 
28 0 176 188 172 148 3 0 3 2 2 3 3 0 2 1 0 2 2 2 2 0 
36 0 120 124 136 148 2 3 1 3 2 3 0 1 2 0 1 3 3 1 3 3 
60 0 144 184 164 168 3 0 1 3 1 1 2 2 1 2 0 2 1 2 1 0 
36 0 136 172 152 132 3 0 3 1 0 0 2 1 2 2 0 2 2 3 2 1 
36 0 140 128 180 148 3 0 2 2 3 0 3 1 0 2 2 2 2 20 13 1 
36 0 164 156 148 168 2 1 3 1 3 0 2 0 3 2 0 2 2 0 0 2 
32 0 144 172 116 160 0 1 2 1 0 3 1 1 2 1 2 1 3 1 0 1 
