980 84 100 64 96 1 3 3 0 2 2 1 1 3 0 2 2 1 2 0 3 
980 80 60 72 88 1 2 3 3 0 3 1 0 1 0 2 2 1 2 3 2 
976 76 52 72 108 3 3 2 2 0 2 1 2 1 1 1 2 3 1 2 1 
1000 60 104 96 84 3 2 3 3 2 0 3 0 3 1 0 3 3 2 1 2 
984 60 80 76 88 0 0 3 0 0 3 2 1 2 3 2 3 1 2 2 1 
972 60 60 72 96 2 1 1 0 1 0 3 0 2 0 0 1 2 3 3 0 
980 48 68 52 104 2 3 2 0 1 3 1 3 2 3 3 1 0 3 0 3 
984 56 76 84 84 0 0 0 1 1 0 1 3 0 1 2 1 3 1 3 2 
972 88 68 88 92 3 2 1 1 2 3 0 3 3 2 3 3 1 0 2 3 
996 60 88 76 92 1 1 2 0 2 3 0 3 3 1 3 1 0 1 2 1 
