992 7 2 1 0 29 16 26 30 22 12 46 33 15 28 5 10 37 24 37 26 
968 5 4 5 4 11 31 24 42 34 29 32 30 13 35 22 26 29 30 28 14 
1000 6 6 6 4 5 21 23 18 26 28 34 32 28 38 25 47 22 19 25 21 
960 2 0 0 5 19 15 15 27 29 32 42 31 13 26 6 0 34 36 25 13 
1032 5 5 1 4 0 18 23 26 18 17 22 16 28 32 26 20 10 13 29 12 
1008 4 2 7 7 14 24 14 26 16 20 23 14 12 15 19 29 33 7 30 20 
984 7 2 2 7 21 40 21 30 28 24 25 34 22 28 18 16 38 33 18 34 
1000 7 4 1 1 18 22 13 26 20 11 22 15 28 30 27 23 31 11 19 15 
960 1 2 7 4 13 31 23 35 9 10 22 17 21 40 30 30 37 32 33 42 
984 7 4 6 2 9 18 19 34 17 14 16 20 28 17 27 23 31 21 19 5 
