280 776 0 0 0 0 1 3 3 1 2 0 0 0 1 3 1 2 0 2 3 0 
284 724 0 0 0 0 3 1 0 0 2 2 2 2 2 0 3 2 0 2 1 0 
272 760 0 0 0 4 3 3 1 3 2 2 0 3 3 2 2 3 0 3 3 1 
280 800 0 0 0 8 0 0 0 0 2 3 2 1 2 2 2 1 3 3 0 1 
280 720 0 0 4 4 1 2 2 2 1 2 3 3 3 2 0 3 3 0 0 0 
280 792 0 0 0 0 2 3 3 1 2 1 2 3 1 2 0 3 0 2 1 3 
280 720 0 0 0 0 0 2 2 3 2 1 3 1 2 1 0 2 2 3 3 3 
284 724 0 0 0 0 3 1 1 3 1 0 1 2 0 0 3 0 1 1 3 0 
280 768 0 0 0 8 2 0 0 2 1 1 0 3 3 1 1 0 1 1 1 0 
284 756 0 0 0 4 1 0 1 1 2 0 0 3 0 3 0 0 2 3 1 2 
