3072 448 8 56 16 8 0 4 2 7 5 6 3 4 15 7 3 7 0 0 4 2 7 2 20 24 23 13 27 20 17 18 19 17 31 29 26 17 17 8 17 29 31 20 37 12 26 44 26 25 7 16 3 12 8 22 18 15 37 41 44 40 20 20 16 31 41 31 27 18 11 20 13 25 37 36 38 23 25 34 23 11 21 13 10 22 
2560 64 16 0 48 24 0 6 2 7 5 4 2 4 3 2 1 6 0 5 7 6 13 27 17 52 22 31 42 35 28 36 18 25 34 26 35 29 27 35 12 26 21 23 18 23 15 24 18 21 13 15 26 13 6 13 4 23 24 40 30 29 28 25 17 18 23 23 6 12 31 30 30 22 19 14 27 25 21 34 20 21 36 23 32 14 
3072 0 56 40 40 48 0 3 4 4 3 3 4 6 7 7 2 7 4 6 6 4 16 25 16 16 18 17 21 24 25 31 18 20 12 9 24 3 20 16 31 44 8 15 27 15 22 14 19 30 11 11 17 7 2 20 7 33 17 23 32 25 17 36 19 20 32 22 13 23 27 17 28 32 6 13 16 13 24 15 22 28 26 34 15 17 
3072 0 0 40 8 32 7 0 0 9 1 7 5 1 7 4 3 2 4 0 3 2 15 16 17 26 2 18 18 15 11 21 26 20 27 23 13 27 20 22 33 44 26 27 38 35 23 15 18 25 10 20 23 24 12 31 18 13 32 23 25 32 26 25 24 41 33 35 13 16 32 22 31 40 12 3 17 9 28 15 14 7 22 19 6 18 
3072 64 40 48 48 8 6 2 0 2 6 1 6 0 11 0 2 7 4 5 6 3 24 30 19 24 19 23 37 24 22 42 22 28 35 21 27 16 12 9 23 40 17 14 27 22 28 25 27 22 26 8 26 10 18 25 15 21 12 26 10 11 13 20 14 28 28 28 31 31 29 33 18 22 27 24 30 14 19 20 26 23 32 15 19 9 
3072 0 24 16 56 0 1 5 1 2 2 2 6 0 5 2 6 5 4 4 2 1 12 32 22 30 38 27 50 27 29 37 29 22 21 21 33 19 7 5 18 12 18 12 35 17 13 19 32 23 13 4 23 31 17 37 14 30 27 22 35 35 26 22 16 19 37 30 28 20 18 33 16 23 34 22 39 26 35 30 26 18 25 20 5 16 
3072 0 24 0 32 16 5 0 1 3 0 5 0 3 6 5 0 5 1 6 6 5 27 23 17 38 5 11 34 34 20 23 11 36 32 20 24 16 8 11 16 27 22 36 23 29 28 32 20 40 15 6 12 15 16 20 25 25 8 3 17 19 39 35 29 28 18 7 26 20 16 21 15 25 10 29 20 32 38 35 27 32 30 18 31 18 
2560 448 8 40 8 56 4 7 5 0 7 0 5 6 7 3 1 4 6 5 1 5 16 30 20 16 28 22 42 23 9 17 12 21 18 13 13 20 32 37 21 28 26 27 32 34 22 19 18 11 34 28 25 24 6 8 7 20 29 37 34 35 30 26 20 17 18 20 17 13 18 22 26 17 26 35 44 32 37 33 11 25 28 5 21 22 
2560 448 40 56 0 56 5 3 2 3 0 1 0 3 2 5 5 4 5 7 5 4 24 41 18 37 20 27 36 38 10 27 10 32 26 4 17 14 3 39 25 26 19 29 33 26 28 19 33 27 22 8 16 5 11 8 7 22 32 40 27 27 1 17 17 11 31 14 23 9 14 15 7 23 5 11 22 23 38 25 18 15 29 21 28 15 
3072 64 32 56 40 32 3 4 6 7 3 7 6 4 4 7 4 2 0 7 10 6 15 13 9 25 10 17 31 17 8 20 0 14 33 22 31 12 25 23 25 22 26 17 31 4 36 28 27 26 15 19 9 7 7 21 7 17 18 26 21 27 22 27 12 29 28 12 26 29 29 25 18 36 34 22 32 32 21 31 14 38 42 24 26 24 
