326 4 0 2 4 
308 0 0 5 9 
331 7 4 6 0 
327 7 4 9 0 
333 0 2 12 2 
302 11 8 11 9 
320 0 8 2 7 
318 1 0 5 6 
329 0 2 2 1 
333 9 12 9 7 
