2650 843 226 218 216 98 4 1 8 11 3 2 5 4 10 18 1 4 9 1 3 4 0 4 7 1 6 1 4 10 1 8 7 6 13 14 6 2 0 1 0 1 2 4 7 0 12 9 3 0 4 0 3 1 10 5 0 20 14 11 4 6 2 5 0 2 3 0 1 7 0 0 2 19 0 1 5 0 18 5 1 0 13 4 6 0 
2597 862 185 194 242 184 3 2 2 1 4 4 3 0 18 5 3 5 16 2 17 3 0 3 1 0 1 0 2 8 0 12 0 0 5 6 0 12 1 0 5 2 2 0 3 6 4 10 9 3 10 0 2 2 2 10 0 13 4 5 11 0 11 2 6 0 3 1 2 1 9 0 3 23 0 0 9 1 4 0 4 0 12 11 9 0 
2690 687 202 194 189 150 0 0 7 3 6 1 11 7 21 14 1 4 26 11 4 2 8 0 9 12 2 0 4 8 0 17 1 3 11 5 0 5 0 4 5 1 0 0 4 0 3 2 1 16 13 3 0 6 10 3 10 12 19 1 7 8 7 10 3 2 4 10 4 3 0 4 0 11 4 8 12 8 0 0 0 2 4 15 2 3 
2601 709 230 166 200 127 1 6 5 6 7 3 2 22 34 8 7 5 21 1 24 3 0 0 2 6 4 10 9 0 0 10 1 1 3 5 8 7 4 7 13 5 2 0 3 10 4 6 0 6 11 0 4 2 0 6 2 8 3 1 11 3 0 4 4 3 3 3 3 0 4 5 1 8 0 0 13 8 4 7 0 0 22 15 5 0 
2680 714 172 222 210 161 9 1 1 3 4 4 2 14 11 9 6 0 7 8 0 4 0 6 9 0 8 4 2 7 0 8 0 16 9 16 11 0 1 4 5 11 2 0 4 1 5 5 10 17 9 4 1 0 0 8 0 11 13 7 6 10 6 0 0 2 3 12 4 6 4 14 2 1 7 0 4 5 0 0 6 7 19 17 20 0 
2677 869 205 175 258 173 2 3 11 4 2 3 2 5 3 17 7 5 10 4 7 1 2 8 0 0 2 0 0 4 1 7 5 4 10 0 5 0 0 0 9 0 0 4 2 9 1 8 0 4 1 0 5 0 1 9 2 17 5 10 10 7 1 8 4 6 2 10 2 13 12 7 4 6 9 0 8 2 5 1 1 5 2 12 5 0 
2666 732 156 218 284 135 6 7 0 3 7 1 9 4 4 2 6 7 3 24 5 2 5 8 3 5 5 0 0 3 2 4 0 0 14 7 2 4 6 4 1 4 1 8 5 22 0 0 4 2 16 9 5 0 1 0 4 12 14 19 12 0 0 6 1 4 0 10 0 1 3 4 16 16 7 3 10 8 4 6 6 0 7 5 1 0 
2640 742 202 167 163 119 2 4 8 4 0 4 3 4 3 17 0 2 20 17 3 1 0 1 0 4 5 0 11 2 2 18 8 0 4 6 4 4 2 3 5 0 0 0 6 7 7 4 2 0 13 0 5 2 1 0 2 3 13 13 5 0 0 0 4 10 0 8 19 9 8 8 1 16 5 5 24 5 6 1 2 1 14 10 0 0 
2840 984 206 209 170 133 1 2 4 4 8 2 6 13 23 0 3 3 17 8 13 2 1 0 2 8 1 3 3 6 0 7 1 10 6 14 4 1 8 0 6 1 5 6 10 3 8 9 1 10 8 6 0 1 3 17 1 18 9 13 6 2 3 0 16 6 0 8 0 0 0 5 0 11 0 2 10 2 9 6 5 7 6 10 14 0 
2651 828 216 220 222 136 4 13 1 7 3 1 1 4 0 24 4 7 21 15 4 5 2 0 0 9 4 0 4 7 3 14 0 0 4 9 7 6 0 2 11 0 4 5 1 0 2 4 5 3 6 5 0 0 0 7 0 21 9 18 5 7 3 1 3 3 0 4 5 4 7 4 4 15 3 4 14 2 1 11 12 0 14 15 4 0 
