947 212 4 7 15 2 0 3 6 12 3 0 11 1 11 13 2 1 9 15 0 3 
934 180 4 4 13 0 4 1 13 2 0 0 7 9 11 2 0 10 14 25 5 0 
949 198 18 14 3 4 0 5 0 7 0 1 12 3 0 3 0 0 9 8 1 3 
918 167 10 4 1 0 0 0 0 2 0 0 23 6 0 3 0 0 23 20 4 6 
932 243 8 7 14 2 0 0 0 14 0 2 16 13 4 4 0 0 16 29 8 0 
963 206 1 4 12 2 0 1 15 0 0 5 7 2 13 6 10 1 7 5 0 2 
919 174 3 1 28 0 8 2 10 17 0 0 7 9 17 7 5 2 18 21 4 17 
911 160 4 0 4 7 0 0 5 19 1 0 12 8 10 5 1 0 20 16 1 2 
928 217 1 7 3 1 0 4 0 8 0 6 15 3 1 4 0 0 13 4 0 0 
919 257 17 7 0 2 3 1 13 13 1 0 1 5 2 4 1 1 21 15 2 3 
