1201 8 1 10 10 1 0 0 16 9 3 4 0 11 5 5 4 7 7 0 7 
1210 3 11 26 9 1 2 0 6 2 0 9 7 7 13 2 4 11 3 12 4 
1180 11 2 7 15 8 0 0 11 0 0 15 3 2 10 6 21 18 0 8 8 
1154 0 1 2 15 3 0 5 6 0 0 5 0 0 14 0 11 9 11 10 6 
1185 4 1 0 5 0 0 0 15 1 0 15 0 5 5 0 2 8 4 8 6 
1203 11 4 4 11 1 1 1 15 2 6 13 22 4 17 0 1 12 0 1 0 
1202 1 5 7 3 3 0 6 18 8 4 17 19 6 0 0 4 12 0 0 0 
1209 0 5 8 4 2 1 2 6 9 4 6 7 0 6 0 10 17 21 6 5 
1208 5 13 5 8 0 0 0 20 3 2 17 1 0 16 4 8 9 0 0 6 
1156 0 12 10 28 0 2 7 6 2 0 6 2 9 21 3 9 17 0 0 7 
