896 56 3 3 0 1 9 18 27 43 8 17 36 27 21 37 17 12 23 23 23 28 
896 48 7 6 0 3 2 7 18 27 15 14 29 21 18 30 12 16 27 28 30 27 
960 8 7 3 3 1 5 21 16 46 12 9 17 15 20 25 11 16 32 31 26 28 
896 0 3 1 7 4 0 1 24 47 11 10 38 23 14 27 3 5 33 17 24 20 
960 48 3 8 4 1 2 10 22 22 0 7 35 15 22 29 14 17 44 18 30 15 
896 16 1 0 0 8 9 6 29 34 17 23 41 32 33 39 23 19 43 23 17 13 
960 0 5 0 4 0 1 23 15 39 4 1 36 15 23 36 6 16 35 24 18 13 
896 16 6 7 2 5 12 26 33 38 8 12 30 22 28 29 29 7 30 19 25 11 
896 8 7 1 2 6 9 17 26 32 26 11 28 20 31 36 36 28 36 25 30 21 
896 16 4 7 1 1 10 8 21 22 1 6 43 10 16 23 11 5 17 26 28 30 
