340 2 0 1 2 
356 0 2 2 1 
364 2 0 1 1 
332 1 0 1 3 
348 0 0 1 3 
336 1 2 3 0 
336 0 3 3 1 
332 1 1 0 3 
332 0 2 1 0 
352 0 3 0 0 
