344 2 2 1 0 
332 2 3 2 1 
352 1 3 3 2 
348 0 0 2 3 
336 0 0 0 3 
308 1 1 3 3 
344 1 2 0 0 
340 2 0 3 2 
352 2 1 0 3 
356 2 1 1 1 
336 0 0 3 0 
340 2 2 3 3 
340 1 1 2 1 
372 2 2 3 2 
352 3 2 2 1 
364 3 0 2 1 
352 1 3 2 1 
300 3 0 3 3 
344 0 0 1 2 
332 3 2 0 0 
344 3 3 3 3 
348 3 1 3 0 
340 3 2 2 1 
340 1 1 2 0 
348 1 0 2 0 
352 3 3 3 3 
300 1 0 1 3 
324 2 2 2 1 
352 3 1 3 3 
372 1 2 0 3 
332 3 0 3 2 
352 2 2 3 3 
368 3 0 2 3 
352 2 0 3 1 
356 1 2 2 0 
332 3 2 3 2 
348 1 3 2 1 
360 3 2 3 0 
336 2 0 2 2 
344 3 0 0 0 
360 1 1 0 1 
348 3 1 0 2 
364 2 2 3 3 
344 3 2 2 3 
348 3 3 0 3 
352 0 1 0 3 
352 2 0 3 2 
336 0 0 0 2 
344 1 2 2 1 
360 2 3 2 3 
308 0 1 1 2 
352 2 0 2 2 
364 2 3 2 0 
336 1 3 2 3 
332 3 3 3 0 
364 3 1 3 3 
328 3 2 0 3 
344 0 2 0 3 
352 2 3 2 1 
352 1 1 3 1 
324 2 1 0 1 
332 2 3 3 0 
348 0 0 2 2 
324 2 3 2 0 
332 0 2 0 3 
340 1 1 2 1 
344 1 0 1 2 
308 2 2 2 0 
344 1 3 1 3 
324 2 3 0 1 
348 2 0 2 1 
360 0 2 1 2 
364 0 2 2 2 
356 3 1 2 1 
336 0 0 2 1 
320 3 1 0 1 
380 2 3 0 0 
348 1 3 3 1 
344 1 1 2 3 
356 2 1 2 2 
