1052 80 72 84 80 1 3 0 1 0 1 1 3 1 1 2 3 0 3 2 2 
1032 88 104 124 120 0 3 2 0 1 2 0 2 3 2 2 2 0 2 1 1 
1056 96 72 92 96 2 3 0 3 1 2 3 3 0 2 3 3 1 1 0 2 
1096 88 112 80 104 3 0 3 0 3 1 0 2 3 0 3 2 1 1 2 0 
1044 88 80 92 124 1 1 2 3 2 3 2 2 1 3 0 2 0 1 2 1 
1060 104 68 108 112 3 1 1 2 2 3 3 0 3 1 1 1 3 3 2 1 
1028 80 116 120 100 3 1 0 2 3 0 1 1 3 1 2 1 2 3 1 2 
1028 88 112 92 160 1 1 0 2 0 0 0 1 3 0 0 2 2 0 1 0 
1100 88 64 108 116 0 1 2 3 3 3 5 2 1 2 1 2 1 0 2 0 
1052 88 104 120 124 0 1 1 3 3 1 2 1 3 3 2 3 0 0 2 2 
988 68 112 96 160 2 2 3 1 3 1 3 2 3 3 2 3 1 0 3 1 
1056 72 120 120 116 2 3 0 2 0 1 3 3 0 2 0 1 0 0 1 0 
1056 96 56 140 104 3 0 2 2 2 0 1 3 2 1 1 3 3 0 1 1 
1044 108 96 112 104 3 2 2 3 3 2 1 2 2 0 0 0 3 1 2 1 
1076 76 100 120 96 1 3 1 1 3 0 2 2 3 2 1 3 2 1 0 3 
1036 68 108 96 144 3 2 1 1 2 1 2 3 1 0 2 0 0 1 3 2 
1048 80 128 104 108 1 0 1 0 3 2 1 2 1 3 3 2 3 1 2 0 
1020 92 76 92 136 3 0 1 1 3 1 1 3 1 3 3 3 2 2 3 3 
1044 144 68 132 116 3 0 1 2 3 2 1 0 2 1 0 3 0 1 2 3 
1024 112 112 92 140 0 0 3 3 3 1 1 2 0 2 1 3 3 0 2 2 
1076 88 88 92 80 0 1 1 1 3 2 2 1 2 2 0 0 1 3 1 0 
1044 72 112 108 176 0 2 3 0 3 3 3 3 2 0 3 0 3 2 2 1 
1028 92 88 92 140 3 0 1 3 1 2 0 5 2 3 1 3 2 3 1 0 
1016 72 156 100 136 0 0 3 0 0 3 3 3 3 2 3 0 3 2 1 1 
1056 72 104 88 128 0 2 3 2 2 3 3 1 1 2 1 3 0 2 2 2 
1056 76 128 112 108 2 0 1 2 3 1 0 0 2 3 0 0 3 3 3 1 
1032 88 128 96 144 1 0 3 1 1 3 3 2 0 1 3 2 2 2 3 2 
1016 80 124 108 104 3 1 0 2 0 1 3 0 3 3 1 0 3 4 3 0 
1060 140 100 88 96 2 2 0 1 5 3 0 1 2 0 3 0 3 2 2 0 
1072 60 56 100 128 1 1 0 0 0 0 1 2 2 1 2 1 7 0 3 2 
1036 80 84 88 140 1 1 3 3 0 1 1 3 3 1 1 2 1 0 2 0 
1072 92 104 92 100 2 3 1 2 1 3 3 1 0 2 3 2 3 0 3 0 
1052 68 104 144 132 0 2 3 3 3 2 2 2 0 1 2 1 1 0 1 1 
1040 60 124 96 116 1 0 3 2 3 1 1 0 2 3 1 0 2 0 1 0 
1008 108 92 140 132 1 3 2 3 2 2 0 2 0 2 2 0 0 1 0 0 
1044 92 96 140 140 0 2 2 3 1 3 0 1 2 2 0 2 2 1 1 0 
1052 88 120 104 124 1 2 3 2 3 3 3 2 2 3 3 1 1 3 0 2 
1052 56 120 104 96 3 2 2 3 3 0 0 2 3 0 3 0 2 3 1 2 
1064 92 116 88 80 0 1 2 1 2 3 2 1 1 1 3 1 3 2 4 2 
1020 84 140 100 112 0 0 3 1 3 1 1 3 2 3 2 2 1 1 2 2 
1056 88 96 112 112 2 3 1 1 3 1 2 2 3 0 2 1 2 0 1 3 
1056 84 120 68 96 0 2 3 3 3 3 3 2 3 0 2 2 3 1 2 2 
1040 80 80 76 156 3 2 2 3 1 3 1 1 0 0 3 3 2 0 3 0 
1056 56 56 100 100 1 1 1 3 1 2 2 3 2 1 3 2 1 0 0 3 
1064 52 96 64 100 2 1 3 2 3 2 1 3 1 2 1 2 1 2 1 0 
1036 88 92 108 116 0 3 2 2 0 1 1 3 2 1 3 2 2 3 1 2 
1036 80 80 128 136 1 3 2 2 0 3 3 2 2 1 2 2 3 3 0 1 
1052 72 108 76 120 0 0 1 3 1 1 1 1 0 3 2 0 0 0 2 2 
1056 108 112 96 88 5 2 0 2 2 3 2 3 3 2 3 0 3 1 2 2 
1060 84 88 80 104 0 3 2 1 3 3 3 2 4 3 1 3 2 1 0 3 
1056 100 88 76 116 0 1 1 1 0 3 0 2 0 0 2 3 1 2 0 0 
1052 88 88 112 72 1 2 3 3 3 3 1 0 1 1 2 0 3 3 3 3 
1044 100 52 112 120 1 0 1 1 2 3 0 3 2 1 2 0 3 3 1 0 
1064 92 108 92 124 2 3 1 2 1 0 1 2 1 2 1 3 3 0 1 0 
1060 84 108 112 112 3 0 2 3 2 0 2 1 1 3 2 3 1 1 3 2 
1048 104 104 84 92 1 3 3 1 5 2 1 2 0 3 2 0 2 2 1 2 
1028 120 104 96 124 1 3 1 1 3 1 1 1 3 0 3 2 2 2 1 2 
1068 68 120 52 112 2 2 1 2 3 0 3 1 3 4 1 0 2 2 3 2 
1024 68 108 96 120 3 2 0 0 1 3 3 2 1 1 3 2 2 3 2 3 
1052 76 68 104 164 0 3 3 2 3 2 2 3 0 0 1 3 0 2 3 1 
1028 100 80 84 100 1 1 1 3 3 0 1 1 3 1 2 1 3 1 2 2 
1016 80 128 92 148 3 3 1 1 2 1 0 1 2 2 3 2 1 2 1 0 
1036 112 92 76 140 3 1 2 1 2 2 0 2 1 3 3 3 1 0 2 3 
1036 68 80 132 128 0 0 0 2 0 2 0 0 0 2 0 2 0 2 3 0 
1064 84 76 124 136 2 2 1 1 0 3 0 3 1 1 3 1 1 2 1 3 
1060 88 100 108 108 1 1 3 1 0 1 7 2 3 3 0 3 0 2 2 1 
1068 60 96 116 116 1 3 0 0 3 0 1 0 1 2 3 2 2 3 1 1 
1052 104 116 152 100 0 3 1 3 3 3 1 0 0 1 2 0 3 3 2 1 
1060 72 76 128 112 3 1 1 1 0 3 0 3 1 1 2 3 1 2 3 1 
1056 96 68 88 124 3 3 2 0 3 2 2 2 0 3 1 3 3 3 3 1 
1052 76 100 108 120 0 0 2 1 0 1 3 1 3 3 2 2 2 3 0 3 
1036 124 104 76 160 1 0 2 0 3 2 0 2 3 2 2 2 2 2 3 2 
1036 72 76 104 136 0 1 3 3 2 0 0 2 2 2 0 1 1 0 2 3 
1032 64 104 116 120 5 0 2 2 0 0 4 0 0 3 0 1 3 3 0 2 
1044 72 128 112 112 3 1 1 2 2 2 3 1 0 2 2 0 2 3 1 3 
996 148 76 100 120 2 2 1 2 1 0 0 2 1 0 1 3 0 3 1 0 
1040 88 100 112 128 0 2 3 3 3 0 0 2 2 1 3 0 1 2 0 1 
1064 96 80 100 80 0 1 2 2 3 3 3 2 1 0 1 2 3 1 3 2 
1064 88 56 88 128 1 3 1 0 3 3 1 2 2 1 1 3 1 0 3 3 
1044 112 60 128 104 1 0 2 0 1 2 0 2 2 0 1 1 0 2 1 1 
