1177 16 11 2 20 3 4 5 14 3 2 12 3 0 9 7 6 16 16 0 14 
1177 8 8 2 18 3 4 0 10 1 1 16 11 1 12 0 0 12 3 0 1 
1194 20 0 2 7 2 0 12 15 0 2 21 0 3 2 0 0 8 12 8 13 
1192 4 11 21 5 0 1 0 16 0 2 5 0 2 18 2 9 18 10 3 0 
1203 3 8 4 22 0 1 2 4 8 2 8 2 2 7 1 5 24 12 4 0 
1211 3 3 4 6 0 2 0 10 0 4 18 0 5 11 0 0 12 6 0 2 
1217 16 7 5 15 1 10 16 11 8 7 13 0 0 6 3 2 14 14 0 3 
1191 10 0 18 12 0 6 0 16 0 0 8 2 5 5 7 0 19 0 3 4 
1198 4 26 12 3 4 0 1 18 1 0 15 0 2 9 0 17 12 0 2 8 
1191 21 18 24 22 6 2 0 11 13 8 16 0 0 16 1 4 15 3 1 0 
1195 3 1 2 3 0 6 0 22 0 0 8 0 0 8 0 0 13 0 4 1 
1230 7 5 7 14 2 9 0 9 0 7 18 0 3 3 7 14 14 27 1 0 
1194 8 1 15 15 1 3 0 15 0 2 14 0 1 12 1 14 2 15 8 0 
1192 4 1 4 2 7 0 15 14 1 0 6 8 3 4 1 1 8 0 6 1 
1131 3 4 7 23 0 8 0 21 0 0 10 0 1 12 2 16 9 0 2 6 
1215 15 9 13 5 0 10 0 8 2 0 12 4 0 13 5 4 7 0 7 4 
1199 3 3 5 7 0 0 2 15 1 1 4 1 9 10 3 0 5 13 0 1 
1212 4 4 0 17 1 10 6 10 1 0 22 8 1 5 0 2 13 0 7 2 
1203 1 2 7 1 1 0 1 9 0 4 20 0 8 12 3 7 12 0 4 4 
1220 10 9 10 24 0 2 0 15 3 0 8 0 7 20 1 5 13 5 16 9 
1216 5 4 4 18 0 6 1 16 0 0 16 9 0 14 5 14 19 6 3 0 
1192 7 10 2 11 0 1 0 12 3 0 8 2 0 9 0 1 10 10 5 3 
1223 8 6 16 3 0 1 3 6 4 2 1 0 6 10 9 2 20 6 2 0 
1210 4 6 6 13 9 0 0 5 0 1 8 3 0 10 0 5 14 0 7 10 
1211 1 2 3 1 1 0 0 6 3 0 6 0 1 14 4 12 0 0 2 0 
1202 12 19 22 14 0 3 2 17 0 0 18 2 10 8 4 4 24 2 0 0 
1189 12 18 13 27 0 0 0 16 0 0 0 9 1 11 1 8 13 2 0 5 
1216 4 0 11 2 0 5 3 11 2 0 9 3 0 18 4 17 13 3 0 8 
1218 18 4 8 27 0 3 0 6 0 2 2 0 0 7 10 11 14 5 10 12 
1204 3 13 15 10 0 0 0 14 2 15 14 4 0 8 9 2 15 0 10 12 
1185 18 4 15 1 8 0 7 9 0 7 13 6 9 16 13 1 16 1 2 0 
1175 1 4 6 2 2 1 0 4 0 2 8 9 2 14 3 11 6 3 7 12 
1187 0 10 2 12 2 1 2 1 10 0 5 11 2 8 0 3 9 21 5 8 
1232 7 5 0 6 0 3 0 5 2 10 6 1 0 23 0 3 17 4 3 1 
1211 12 0 23 8 3 3 4 3 0 0 9 8 5 6 4 6 14 13 12 6 
1227 8 12 0 25 0 6 0 12 4 7 17 0 1 5 0 9 28 2 7 8 
1178 10 2 4 0 0 1 8 16 9 0 11 0 4 6 15 15 7 4 5 2 
1219 5 8 6 16 0 0 2 16 1 0 9 11 2 18 0 3 15 12 4 7 
1210 0 6 8 2 9 8 1 1 7 1 17 4 5 10 0 7 19 7 0 2 
1210 5 9 6 9 0 0 0 3 1 3 7 14 7 18 0 3 2 7 3 4 
1205 4 13 4 10 0 0 1 12 0 0 9 7 2 17 0 0 10 4 0 2 
1181 2 7 16 6 0 1 2 20 1 1 18 5 11 17 1 1 13 13 1 2 
1203 9 14 4 18 0 12 4 21 2 0 8 18 0 20 3 3 6 5 12 0 
1210 3 10 16 4 2 2 3 6 2 0 6 2 2 14 5 0 0 4 0 1 
1183 4 4 1 16 1 0 0 6 0 1 22 2 0 12 9 0 17 5 3 1 
1216 4 1 18 4 0 1 3 18 0 0 10 9 2 11 0 3 8 6 5 0 
1220 2 0 3 16 2 0 8 15 0 0 2 9 6 5 1 1 8 0 0 4 
1227 0 1 3 4 4 7 0 15 0 0 12 2 0 5 0 5 6 2 1 0 
1227 6 2 7 4 15 7 12 11 1 4 1 4 1 16 3 4 7 0 5 2 
1203 3 7 5 20 0 0 0 14 4 1 12 1 7 11 0 0 8 10 1 0 
1206 16 14 2 2 19 1 11 7 3 2 7 5 4 3 11 7 11 6 12 2 
1235 5 3 7 4 0 2 4 16 11 0 3 0 3 20 0 2 21 6 2 5 
1204 7 10 2 32 3 1 3 15 8 6 21 7 2 14 9 4 14 3 6 6 
1236 23 2 12 2 2 1 1 17 0 0 19 4 6 14 4 3 9 0 2 5 
1218 1 4 13 16 7 0 0 10 0 0 16 0 1 4 6 2 14 28 2 0 
1191 6 9 3 10 4 0 0 10 6 10 16 6 3 12 3 8 7 4 12 13 
1235 1 2 7 4 0 2 1 5 2 0 11 1 9 6 1 4 10 3 0 2 
1246 14 4 10 14 0 3 1 19 4 0 11 5 3 3 0 0 4 0 9 5 
1200 14 4 7 17 2 2 0 13 4 3 17 8 7 12 3 3 24 0 7 0 
1208 13 6 6 7 0 3 2 8 0 5 7 0 2 16 0 3 10 1 2 15 
1211 22 10 9 20 0 1 2 11 1 0 18 9 5 15 0 9 8 0 5 15 
1211 4 4 0 2 6 1 1 10 1 2 9 10 0 0 0 1 9 1 0 1 
1164 5 3 4 15 0 4 14 14 0 0 8 0 7 15 0 0 18 4 0 0 
1208 3 2 0 4 5 10 4 1 3 0 16 6 1 12 9 3 14 0 1 3 
1217 17 6 1 7 0 0 3 21 0 0 11 7 7 6 0 1 15 0 0 4 
1184 7 4 3 5 3 1 3 6 7 0 8 0 4 6 1 2 8 6 6 2 
1212 3 3 4 17 7 6 0 11 0 14 8 10 0 6 0 13 16 8 8 0 
1186 0 1 13 18 1 1 21 0 4 0 10 0 1 15 3 0 18 2 0 13 
1169 4 2 11 30 5 3 8 15 0 3 9 12 2 5 2 0 16 4 2 9 
1204 9 0 1 17 0 0 0 20 0 0 15 6 0 7 0 1 5 11 0 5 
1224 4 10 18 3 3 1 2 8 0 5 10 0 9 17 1 0 9 6 3 0 
1235 5 4 5 9 0 0 0 5 7 3 5 0 2 4 12 8 7 4 2 16 
1184 9 3 9 4 0 0 1 20 1 2 19 6 7 17 4 4 3 0 1 1 
1198 0 15 14 18 1 0 0 7 8 0 17 3 8 9 0 6 23 6 0 0 
1199 5 0 15 14 1 0 2 6 1 0 7 9 3 6 4 0 1 5 5 5 
1214 8 3 14 3 7 3 1 11 5 3 8 11 0 7 8 0 19 9 1 8 
1201 2 19 6 13 0 1 4 17 0 0 16 18 0 16 6 11 19 4 11 0 
1197 6 3 4 4 0 5 0 7 1 1 12 4 5 6 1 4 13 1 13 3 
1199 18 0 7 13 0 6 4 5 6 6 0 6 2 12 3 13 9 7 0 0 
1228 7 2 11 14 0 1 1 9 3 1 6 3 0 8 3 1 10 0 3 0 
