284 700 0 4 0 0 2 0 0 1 2 1 0 2 0 0 2 2 3 3 2 2 
288 760 0 0 0 0 1 1 0 1 2 0 2 0 2 2 1 3 0 3 1 3 
280 748 0 0 0 0 1 0 3 1 0 3 1 2 1 1 3 1 1 3 3 0 
280 736 0 0 0 0 0 2 0 2 2 0 1 1 3 0 3 1 1 1 1 2 
292 724 0 0 0 12 0 2 3 0 3 2 0 1 1 0 0 2 3 1 3 2 
276 768 0 0 0 0 2 2 2 2 0 3 1 0 2 1 2 0 0 0 3 0 
284 736 0 0 0 0 0 3 3 1 3 2 2 3 1 1 2 0 3 1 0 0 
276 728 0 4 0 0 1 0 0 1 3 1 3 0 1 1 3 3 2 2 2 3 
280 744 0 0 0 0 2 3 1 3 0 3 1 2 2 2 3 2 3 1 3 0 
280 756 0 0 0 0 0 0 3 1 1 1 2 1 2 2 1 1 3 2 0 0 
280 740 0 0 0 0 3 2 2 2 2 2 0 3 2 1 3 3 3 2 3 3 
288 768 0 0 0 24 3 0 0 3 2 3 3 0 2 3 1 3 3 0 1 1 
280 716 0 0 0 0 0 1 3 3 1 0 0 1 3 1 2 0 1 2 3 1 
280 740 0 0 0 4 2 2 2 3 3 0 1 0 2 3 2 0 3 0 1 0 
272 768 0 0 0 4 1 3 2 1 1 2 0 0 1 2 2 0 3 0 3 1 
280 772 0 0 0 0 2 2 1 3 1 0 3 1 3 1 3 2 3 0 0 2 
280 796 0 0 0 0 3 3 3 0 2 3 3 1 1 1 1 1 3 0 0 3 
268 744 0 0 0 0 1 2 3 0 3 2 1 0 3 0 0 2 2 1 2 3 
276 736 0 0 0 0 2 3 1 0 2 0 2 3 0 2 0 1 2 2 1 1 
280 716 0 0 0 0 2 1 0 3 0 1 0 2 0 1 2 2 0 2 2 2 
276 744 0 0 0 0 3 0 2 2 2 0 2 2 0 1 2 1 0 0 3 2 
288 708 0 0 0 0 1 3 2 1 1 2 1 2 2 3 1 0 2 2 2 0 
276 768 0 0 0 0 1 0 0 0 3 2 0 0 0 0 1 0 3 0 0 3 
276 764 0 0 0 0 2 2 0 1 2 0 2 1 3 3 1 3 3 0 0 2 
284 720 0 0 0 0 0 2 2 3 3 1 0 0 1 3 1 1 3 3 2 2 
288 748 0 0 0 0 2 2 2 0 0 2 2 1 1 0 0 0 1 0 3 3 
284 732 0 0 0 0 2 0 0 0 2 1 0 3 2 3 1 2 3 2 2 1 
292 712 0 0 0 0 3 0 0 1 0 3 1 3 1 3 1 3 2 3 1 0 
276 740 0 0 0 0 2 0 1 3 3 1 2 1 3 2 1 2 1 2 0 3 
284 704 0 0 0 0 2 0 0 1 1 0 1 1 2 2 0 3 2 1 0 2 
280 760 0 0 0 0 3 2 0 2 1 3 0 0 3 1 3 0 3 1 2 0 
288 724 0 0 0 0 1 3 1 0 1 2 1 3 3 3 3 0 1 1 1 1 
280 752 0 0 0 0 0 0 0 1 1 2 3 1 0 0 2 2 3 0 1 0 
280 680 0 4 0 0 0 3 2 1 0 3 1 2 2 1 0 1 3 2 3 0 
292 740 0 0 0 0 3 0 3 3 1 3 0 2 2 1 0 2 3 2 3 1 
284 732 0 0 0 4 3 0 2 3 1 1 3 1 1 2 3 0 1 3 2 1 
272 744 0 0 0 0 1 2 2 2 1 2 1 2 0 0 1 0 0 0 2 3 
272 744 4 0 0 0 2 3 2 2 1 0 1 3 0 1 0 1 2 2 1 1 
272 732 0 0 0 4 2 2 3 1 2 2 1 1 2 0 1 2 3 0 2 1 
276 772 0 0 0 0 0 0 2 3 1 1 0 1 3 3 2 1 1 3 2 2 
276 764 0 0 0 0 0 0 2 0 3 2 3 2 2 2 3 2 3 2 1 1 
284 740 4 0 0 0 0 2 0 0 0 1 2 2 2 1 3 2 3 2 2 0 
272 752 0 0 0 0 0 1 3 1 1 0 3 1 0 2 0 2 3 3 1 3 
276 764 0 0 0 0 3 3 1 0 1 1 2 1 2 0 1 0 0 2 3 3 
280 752 0 0 0 0 3 3 1 0 0 2 1 0 0 3 0 3 3 2 0 0 
284 720 0 8 0 0 3 2 2 2 2 1 0 1 3 2 1 1 3 2 3 3 
284 712 0 4 0 0 1 0 2 0 2 0 2 2 2 2 0 3 0 1 3 0 
288 756 0 0 0 0 0 0 3 0 3 0 2 3 0 1 2 1 1 0 3 2 
284 780 0 0 0 0 3 0 2 3 3 2 0 2 2 3 0 1 3 1 2 1 
280 756 0 0 0 0 2 2 1 2 2 0 3 1 1 2 2 3 1 3 0 2 
280 768 0 4 0 0 1 2 0 2 3 2 2 1 0 1 2 1 2 0 0 0 
284 736 0 0 0 4 3 3 1 3 0 1 2 3 2 0 2 1 1 3 3 2 
284 704 0 0 0 0 0 0 3 2 1 0 3 2 3 1 1 1 0 2 3 2 
276 748 0 0 0 0 0 1 2 1 3 3 0 0 2 3 1 0 3 1 3 2 
280 760 0 0 0 8 0 3 0 0 0 0 2 0 1 0 1 1 0 0 1 0 
280 688 0 0 0 0 3 3 0 2 0 0 2 3 1 3 2 2 3 0 1 2 
272 756 0 0 0 0 0 3 1 2 3 1 1 3 2 3 0 0 1 0 2 0 
280 752 0 0 0 0 0 2 0 0 3 0 3 3 2 2 0 2 0 3 1 1 
284 764 0 4 0 0 3 1 2 3 3 3 3 1 2 1 3 0 3 0 2 1 
288 752 0 0 0 0 0 1 1 0 2 3 3 1 0 0 0 3 2 2 3 2 
284 768 0 0 8 0 1 0 2 3 1 3 3 0 0 3 2 0 1 0 1 2 
276 724 0 0 8 8 3 3 1 2 0 1 2 1 3 1 1 3 3 3 2 3 
276 772 8 0 0 0 2 2 2 1 0 1 1 0 2 1 0 3 2 1 3 2 
288 740 0 4 4 16 3 2 2 3 2 2 1 0 3 1 0 1 0 1 0 1 
284 776 0 0 0 0 2 1 2 3 1 1 2 3 1 3 2 1 3 1 0 3 
280 748 0 0 0 0 2 0 1 3 3 1 2 2 2 0 0 0 1 0 3 3 
288 716 0 0 0 0 1 1 1 3 3 3 2 2 1 3 3 0 3 2 3 0 
280 780 0 0 0 4 2 1 1 2 1 0 3 1 2 2 2 2 2 0 0 3 
276 748 0 0 0 0 1 1 2 1 1 1 1 0 3 1 0 3 1 2 1 0 
276 776 0 0 0 8 1 2 2 1 0 2 1 2 2 3 1 2 1 3 1 0 
284 780 4 0 0 0 3 2 2 2 2 2 3 3 0 0 1 0 1 2 2 2 
284 752 0 0 0 0 1 1 1 0 3 2 3 0 2 0 0 3 0 2 0 0 
276 776 0 0 0 0 2 3 0 3 2 0 0 2 3 0 3 0 0 2 2 2 
276 760 0 0 0 12 3 2 0 1 2 2 0 1 0 3 1 1 2 0 3 2 
276 728 0 0 0 0 3 3 2 2 1 1 3 3 2 0 3 3 0 3 0 1 
288 764 0 0 0 0 0 2 0 3 1 3 1 1 3 1 1 3 2 1 1 2 
280 772 0 8 0 0 0 3 1 1 2 2 1 0 3 0 1 2 1 2 0 1 
288 756 0 0 0 0 3 2 0 3 1 1 0 3 3 1 1 3 2 2 0 1 
288 752 0 0 0 0 3 1 3 2 2 0 0 2 2 0 2 3 1 2 3 2 
284 764 0 0 4 4 1 1 3 1 1 0 2 1 3 1 0 0 0 0 1 3 
