832 0 5 7 1 6 3 18 27 48 9 11 31 27 31 25 14 11 45 34 37 8 
896 32 7 5 1 6 2 11 24 28 7 11 34 28 30 35 18 35 35 30 31 18 
896 8 7 7 3 4 2 10 18 31 13 11 41 21 34 36 34 32 32 25 30 22 
960 8 1 4 5 3 4 18 23 23 6 7 27 16 23 29 11 10 27 27 34 16 
832 56 2 1 2 3 13 25 19 24 18 8 30 23 31 32 19 30 39 26 28 14 
960 40 0 7 4 4 11 11 22 29 20 17 20 23 26 33 16 17 39 29 21 10 
960 48 4 7 2 4 14 27 28 31 5 8 24 17 19 28 15 9 31 35 21 27 
832 0 0 6 3 2 27 39 27 35 24 27 30 37 34 28 22 19 31 27 8 15 
832 0 4 2 4 7 4 4 7 18 2 0 21 13 11 34 8 12 38 24 39 16 
896 48 6 6 6 5 8 11 27 24 16 9 33 22 12 19 12 13 35 16 12 16 
960 32 7 4 6 0 6 20 17 26 11 1 32 18 17 32 20 10 39 21 20 5 
960 24 2 6 5 4 13 14 17 19 11 8 18 22 20 32 40 28 33 18 17 23 
896 24 6 2 4 3 7 16 28 31 16 12 43 39 20 18 7 7 42 22 38 26 
896 48 7 1 7 6 8 27 13 26 14 18 33 47 17 28 23 13 21 22 20 12 
832 56 1 0 7 4 6 13 31 39 3 13 30 27 28 34 21 29 39 33 35 38 
896 56 4 2 9 4 11 12 7 24 23 8 31 21 27 34 21 29 34 14 18 11 
896 40 4 7 2 4 8 12 16 39 18 13 35 18 17 33 17 23 36 21 17 10 
832 0 7 3 4 1 16 27 38 31 28 7 34 27 13 20 1 5 39 36 14 22 
832 8 4 1 7 3 8 10 18 21 31 5 31 22 30 45 18 32 35 26 22 24 
896 0 7 6 5 2 6 22 24 32 5 12 29 27 24 24 16 15 52 47 26 34 
832 56 0 3 0 5 6 21 10 33 26 5 38 17 21 42 36 29 35 40 37 20 
960 48 0 4 7 6 26 8 19 23 20 24 39 34 21 24 16 37 28 20 3 8 
896 16 6 2 6 7 4 2 19 28 23 12 34 27 21 24 1 7 47 37 14 31 
896 8 19 5 2 3 8 5 31 34 15 12 37 25 24 16 3 8 33 23 25 34 
896 0 5 1 6 6 6 0 14 22 6 9 33 14 18 27 2 13 37 38 18 24 
896 24 6 5 6 4 3 20 20 19 9 1 37 23 37 38 32 24 34 29 24 27 
896 56 0 4 6 4 2 21 16 36 10 10 27 17 19 28 9 25 20 13 13 5 
832 40 1 2 0 5 4 24 28 34 12 29 41 32 29 43 1 16 39 32 31 9 
896 40 3 4 5 0 7 7 17 34 8 4 39 35 16 22 9 16 34 25 33 9 
832 40 3 3 2 7 10 5 25 25 16 12 21 18 29 33 13 19 35 27 26 39 
896 8 6 0 1 1 20 16 28 33 31 18 33 17 38 27 14 16 27 25 34 22 
896 0 3 6 0 4 0 4 15 29 12 14 30 23 19 28 14 21 26 25 20 16 
896 48 2 4 6 2 25 6 16 40 20 31 41 29 19 39 12 16 24 19 8 1 
896 40 5 1 6 0 3 5 13 26 24 25 25 20 9 31 7 23 47 39 24 25 
896 40 2 1 1 1 13 12 21 15 7 9 27 24 27 32 5 30 37 20 39 20 
896 48 3 6 6 3 0 14 9 19 0 0 21 18 17 22 9 14 42 30 22 16 
896 8 4 4 2 3 18 24 23 27 15 21 31 27 22 15 14 11 35 23 27 13 
960 56 2 1 4 5 0 22 24 34 30 23 39 22 26 26 25 15 38 25 34 30 
896 56 7 4 4 6 8 21 22 35 3 12 16 20 13 29 3 18 33 20 17 19 
896 48 5 1 6 7 7 13 25 14 17 6 31 38 22 31 20 23 38 33 20 20 
896 48 2 7 7 4 0 25 36 35 6 9 22 16 32 35 23 28 30 8 13 12 
960 16 4 2 6 7 7 0 12 22 20 14 37 24 25 20 15 8 39 20 23 15 
896 32 4 3 0 5 18 22 27 35 4 10 18 21 25 26 25 20 45 35 37 42 
896 8 5 7 6 6 9 25 21 30 35 30 37 42 38 34 17 28 33 34 19 16 
896 40 4 3 9 2 8 3 3 14 10 11 29 30 23 24 3 13 41 30 29 32 
896 48 6 5 1 9 17 18 23 20 10 11 24 26 25 43 11 16 27 18 20 19 
896 32 7 4 7 6 6 4 35 37 11 11 30 31 20 38 26 33 31 37 31 28 
896 40 4 1 4 5 18 12 43 37 17 11 24 9 25 27 11 14 33 34 21 20 
896 16 0 4 6 2 25 14 28 30 20 14 36 23 15 35 24 28 28 29 30 32 
896 32 2 6 1 3 9 18 26 28 24 26 29 35 13 27 12 11 24 35 34 19 
960 16 6 0 0 2 10 17 17 29 11 11 28 17 28 38 18 20 29 12 11 8 
896 56 2 5 5 2 5 22 12 16 12 4 30 34 26 41 21 17 37 33 19 20 
896 40 3 5 6 2 11 19 27 30 19 13 13 23 6 22 4 20 47 36 35 17 
896 32 5 3 0 4 3 16 15 35 17 19 35 37 34 42 30 29 26 18 25 9 
896 16 2 7 5 4 15 24 37 31 10 23 39 36 18 22 13 14 30 19 23 16 
896 56 3 4 5 5 0 14 14 38 3 23 29 16 26 31 8 21 33 36 44 14 
896 40 5 3 5 5 16 26 25 27 0 15 35 31 33 30 28 16 23 24 22 33 
896 0 5 1 3 6 3 4 11 13 14 24 40 36 21 37 18 24 25 37 29 23 
896 40 3 0 1 1 8 23 23 47 22 4 22 24 23 24 12 14 25 18 10 8 
960 8 0 4 2 4 16 23 16 28 8 5 24 22 24 32 16 10 32 29 15 10 
960 0 7 0 5 4 9 16 14 32 4 0 18 18 27 27 8 11 23 31 19 22 
896 32 7 6 3 2 6 19 0 33 4 13 36 20 34 36 24 28 45 37 30 27 
896 8 4 4 0 7 3 3 14 25 18 4 40 30 30 24 11 15 47 21 22 37 
960 48 1 4 7 7 7 4 24 25 13 7 29 31 20 47 11 24 33 29 24 16 
896 56 5 2 4 0 9 7 23 25 12 14 30 34 27 39 6 14 23 21 12 15 
896 40 10 5 4 2 3 13 8 24 27 26 36 32 11 29 20 18 32 19 32 15 
896 8 2 6 5 7 0 4 14 27 14 11 27 9 14 42 17 12 34 14 10 9 
896 8 2 4 2 2 16 12 34 35 22 15 30 26 29 33 12 22 22 19 13 0 
896 16 7 5 5 4 0 2 19 34 12 17 49 32 11 18 5 4 32 38 28 27 
896 40 1 7 6 0 9 8 21 39 8 7 30 29 13 20 3 8 47 25 31 18 
896 56 7 5 6 0 6 10 25 32 12 4 31 32 31 28 19 18 20 27 37 8 
896 48 1 2 7 6 11 8 14 21 8 14 38 13 29 34 10 17 37 36 19 30 
896 32 0 2 2 7 18 26 33 32 9 0 31 22 28 44 18 40 31 32 16 12 
960 24 2 0 3 6 21 12 27 28 13 5 30 12 30 32 10 13 22 30 16 17 
896 56 0 6 7 0 4 21 17 31 11 12 38 22 28 33 11 14 36 26 23 17 
896 0 2 3 7 3 5 13 23 31 7 0 20 12 14 30 14 25 24 28 24 8 
896 24 5 2 7 0 3 16 23 31 15 10 30 20 31 33 19 17 35 29 36 23 
896 56 1 7 5 5 14 10 18 40 25 24 39 22 24 32 27 25 31 37 26 22 
896 24 0 1 5 2 10 7 26 28 16 27 37 42 14 29 4 8 41 30 16 8 
896 0 6 4 0 10 24 12 38 28 16 8 25 15 36 35 15 0 39 29 10 7 
