976 1 3 7 5 23 22 10 36 25 18 26 29 10 33 4 26 27 13 15 16 
992 4 3 3 4 23 18 14 28 24 10 36 37 24 39 13 13 33 18 13 9 
984 7 5 6 4 16 16 16 21 21 31 29 18 33 15 21 11 36 29 26 25 
1056 5 5 4 6 29 14 11 24 2 5 28 18 23 40 19 22 27 20 28 18 
1048 7 6 5 3 18 8 27 25 12 2 32 23 18 35 24 19 26 18 27 20 
944 7 5 4 4 18 23 23 31 5 10 40 44 31 28 23 22 32 27 25 18 
960 7 2 7 5 17 14 29 25 27 29 45 45 37 37 12 31 32 7 15 18 
1000 5 1 2 2 16 31 15 39 41 34 27 32 21 22 5 17 25 27 22 19 
992 7 2 4 3 27 21 12 16 27 20 33 24 16 20 27 12 26 11 16 22 
1000 1 7 4 1 14 32 17 31 10 10 17 33 16 26 26 20 32 26 32 35 
1032 1 0 11 7 26 22 32 19 11 11 32 28 13 24 16 15 36 25 24 14 
968 0 7 3 2 5 15 15 18 16 4 31 16 30 38 24 27 36 24 25 23 
984 4 2 0 3 5 10 13 32 30 19 34 35 16 17 16 9 10 8 25 13 
1016 2 1 5 6 8 24 20 38 15 25 30 24 18 30 23 33 34 17 7 4 
992 5 0 6 7 1 21 11 28 29 25 40 23 11 12 14 18 34 32 27 28 
984 6 6 5 0 5 24 14 27 30 27 51 31 32 38 22 15 16 27 14 22 
936 2 5 1 2 29 9 30 27 20 29 30 37 16 26 26 7 25 19 34 25 
976 4 6 1 7 11 5 15 24 24 24 36 31 12 24 25 19 37 31 44 23 
976 3 3 2 1 9 37 19 38 29 21 37 17 24 35 28 23 20 10 28 19 
976 0 0 6 5 9 25 20 20 20 32 46 31 22 13 11 7 29 22 11 19 
944 4 5 4 7 30 34 38 38 18 20 21 20 24 32 19 18 39 22 21 26 
968 1 6 1 0 23 20 20 25 21 33 39 26 7 40 22 20 34 34 19 36 
936 6 4 2 5 24 41 25 19 29 29 29 31 27 28 15 36 32 23 40 19 
984 3 2 3 2 36 14 19 41 15 13 20 26 1 47 13 23 29 22 21 23 
1024 5 3 6 1 0 11 5 22 16 12 16 27 15 37 27 27 26 23 26 23 
960 0 0 4 6 22 21 28 34 27 19 37 31 24 32 18 27 30 21 14 11 
968 2 0 0 7 20 19 11 24 6 9 23 26 24 25 21 19 30 23 25 20 
976 3 0 5 4 29 22 25 30 11 10 18 30 30 28 21 24 36 27 16 14 
1016 6 3 6 6 15 25 29 31 28 22 21 19 28 18 16 7 21 25 29 21 
1000 2 5 6 1 11 2 20 20 9 17 37 27 24 39 30 27 32 24 16 20 
1040 6 6 4 1 14 17 11 26 19 17 34 28 16 29 16 6 28 18 18 21 
976 6 3 2 3 14 15 23 28 21 25 27 24 41 24 23 22 15 5 15 20 
1024 4 2 7 3 11 26 20 22 26 16 24 24 26 20 24 29 41 25 22 21 
952 5 4 2 4 32 16 23 39 27 20 30 29 27 42 24 34 29 21 14 26 
1000 0 5 6 6 30 15 26 27 12 19 40 33 28 36 23 12 34 32 38 14 
1000 0 6 5 5 33 18 33 23 12 10 22 34 31 24 29 34 25 5 14 1 
936 5 1 0 5 21 23 40 40 7 15 17 22 27 44 32 31 35 33 29 22 
1000 7 1 4 0 15 26 20 20 21 9 25 21 28 20 19 26 42 28 20 15 
1016 6 1 7 0 8 13 12 24 14 13 26 25 29 35 21 30 27 33 26 19 
992 3 0 6 5 43 19 23 35 22 14 24 21 14 15 18 29 35 40 19 22 
976 1 1 7 3 20 19 7 24 28 36 42 43 28 29 28 35 30 31 28 29 
1008 5 7 7 6 16 13 10 19 5 15 31 23 19 18 20 26 35 24 22 24 
1032 3 4 1 0 8 12 15 19 20 22 32 16 15 36 29 20 23 22 8 10 
1032 8 0 2 7 19 22 12 24 20 24 29 18 17 17 8 8 37 23 18 7 
968 4 7 7 2 9 16 8 21 19 30 36 26 18 40 14 40 35 35 34 23 
944 4 4 5 1 18 36 24 36 20 16 26 32 19 32 22 15 24 30 31 22 
1016 5 4 2 3 14 15 14 23 8 14 14 18 9 19 21 28 37 20 21 24 
984 3 5 5 7 4 14 12 19 16 21 31 29 20 25 19 23 42 18 51 31 
968 1 0 3 2 16 22 8 41 16 19 42 12 25 18 29 27 25 13 15 19 
960 6 5 0 2 10 16 8 34 36 28 39 31 39 24 23 21 31 29 8 32 
968 6 3 0 2 18 17 24 28 17 15 23 34 20 42 8 11 24 14 16 14 
1016 4 7 6 2 3 16 10 15 15 19 29 27 15 36 8 15 20 29 18 20 
976 2 2 5 0 21 28 14 37 12 14 13 31 16 31 17 25 43 36 24 45 
920 3 4 0 0 23 20 34 44 29 24 28 42 11 11 29 17 45 26 32 43 
1008 2 6 5 5 11 14 25 29 23 19 31 25 24 33 8 22 37 9 21 17 
1008 5 4 2 4 12 22 31 22 6 3 31 14 17 30 24 31 26 19 21 6 
968 1 0 5 5 17 30 24 30 0 11 25 17 20 24 16 26 38 35 33 26 
984 1 3 3 7 27 14 13 27 23 29 33 15 16 20 4 9 22 24 13 16 
1008 0 4 6 7 13 23 18 22 8 24 32 17 19 21 12 3 25 25 37 25 
1032 1 0 3 3 32 27 18 15 20 12 23 29 29 25 12 10 30 28 31 33 
984 5 6 4 8 18 2 16 33 13 16 27 25 16 26 16 14 23 12 26 19 
1048 7 3 7 1 18 32 26 25 8 14 18 15 26 33 24 22 36 14 17 9 
984 4 1 7 5 10 32 24 34 10 11 30 21 25 29 13 35 25 30 27 20 
1016 4 4 2 2 19 18 22 28 9 21 19 26 13 24 5 1 32 24 32 26 
952 1 2 4 2 25 17 23 27 8 7 28 34 19 26 32 14 31 38 31 32 
952 2 6 0 5 16 36 24 33 12 22 28 32 28 25 39 20 28 37 26 27 
960 6 1 3 2 11 27 15 25 13 26 19 28 20 33 27 29 29 33 22 36 
952 5 3 2 5 7 14 14 31 22 30 21 28 46 43 20 36 41 27 33 37 
984 3 4 1 1 14 35 18 29 31 45 20 34 5 18 16 12 36 11 28 17 
1008 5 4 1 5 24 18 5 24 27 26 15 25 24 32 19 23 37 27 32 22 
1000 6 4 5 2 19 27 15 18 7 14 20 17 24 23 21 15 35 21 22 31 
1040 2 5 1 1 11 13 12 29 5 10 28 22 29 28 27 40 33 26 28 16 
936 1 1 7 7 25 22 33 35 8 21 30 22 22 39 37 23 34 22 40 15 
1024 7 0 3 2 2 15 9 22 12 14 30 12 22 21 15 26 36 10 28 28 
1008 7 6 4 3 20 14 18 32 16 27 25 25 16 28 0 19 28 11 17 23 
1040 1 0 6 1 12 3 19 20 24 6 22 21 16 30 12 30 31 23 29 19 
1016 6 3 6 3 26 24 15 25 12 5 16 24 20 22 9 18 36 15 24 9 
976 1 2 6 0 35 30 39 37 19 17 29 18 21 15 30 24 26 16 35 23 
1024 10 6 7 5 9 22 17 32 30 26 39 26 21 21 18 19 44 12 24 12 
936 0 3 3 1 9 9 16 24 27 30 40 32 27 30 14 24 29 25 35 38 
