2560 384 48 48 0 48 1 4 6 5 7 0 1 6 5 0 1 2 5 2 6 4 23 5 29 39 25 16 26 20 6 25 21 24 27 28 41 35 15 16 25 23 14 13 27 30 19 28 20 10 16 5 7 11 22 34 20 44 29 27 29 38 21 36 38 30 13 27 17 12 15 30 21 22 32 29 37 36 22 34 24 33 34 20 38 18 
2560 0 8 56 56 40 3 3 5 12 1 5 5 2 8 0 5 3 5 5 1 4 13 16 27 19 19 20 28 29 15 29 11 26 30 38 48 42 25 19 34 37 30 14 19 19 31 29 22 15 11 8 12 9 17 27 6 11 26 37 15 20 16 10 13 17 19 18 24 4 23 24 29 21 20 14 19 11 13 21 31 27 30 20 34 22 
3072 448 56 0 0 24 4 6 4 1 1 1 6 5 7 7 1 7 4 9 4 1 19 9 12 31 24 17 30 25 13 15 10 16 22 24 26 24 12 5 13 13 7 13 25 18 27 29 21 22 27 22 37 26 27 27 18 30 17 11 22 26 27 35 15 26 41 29 29 27 21 20 20 29 24 11 29 18 43 25 13 24 25 18 19 21 
3072 448 32 48 0 56 4 7 11 7 2 3 7 6 7 0 0 4 5 1 6 2 31 15 16 24 30 5 35 24 13 17 13 6 19 11 17 21 13 3 19 14 19 29 13 20 24 21 27 14 18 24 27 27 10 13 20 27 32 21 32 18 22 29 25 17 28 20 35 37 23 16 40 26 21 31 29 20 28 33 26 16 31 20 20 12 
2560 384 40 56 56 56 6 0 6 0 2 0 7 5 5 3 6 7 2 7 7 6 13 24 18 25 22 21 41 41 10 25 12 22 24 35 24 28 9 18 9 29 7 2 18 19 18 31 21 13 34 28 25 10 12 22 19 36 36 26 29 21 26 34 29 14 16 19 12 22 7 7 9 5 18 11 10 1 40 46 25 27 22 20 30 21 
2560 64 48 32 40 56 0 2 0 3 0 7 5 1 4 4 7 0 5 4 2 0 26 28 31 27 19 19 34 25 27 30 16 29 16 24 24 26 16 16 26 24 9 0 16 18 33 34 28 34 28 22 23 9 9 14 19 19 25 29 29 24 25 35 5 18 19 25 22 19 24 32 40 37 9 8 18 15 5 35 17 25 22 19 16 23 
2560 448 56 16 32 16 1 4 0 3 5 3 1 0 1 3 0 7 5 0 5 1 10 25 22 21 15 11 23 24 15 26 4 20 37 34 31 21 12 17 28 32 26 20 34 38 6 31 17 29 30 20 14 25 7 24 12 22 23 24 32 31 34 38 20 25 28 16 22 35 23 18 21 32 22 26 34 21 25 51 28 23 41 17 27 18 
2560 0 16 8 40 16 2 6 6 7 5 4 10 6 1 0 2 6 0 6 7 4 17 17 30 34 18 19 31 27 19 36 22 16 26 30 24 33 32 31 25 32 21 21 40 40 19 12 17 22 23 24 24 22 11 8 11 14 9 3 13 30 31 22 35 19 35 24 21 26 11 13 11 26 24 10 24 18 10 21 21 8 18 10 13 7 
3072 0 24 56 56 40 0 3 2 1 4 4 0 2 3 7 5 0 4 6 7 7 26 22 13 27 25 18 31 21 4 15 17 25 32 16 27 15 14 10 35 30 23 14 37 19 32 41 31 28 27 9 24 15 15 32 17 31 17 13 22 18 25 27 18 18 27 20 22 24 17 23 9 22 4 9 20 21 14 29 19 22 33 17 22 7 
3072 0 0 32 8 24 9 5 6 4 1 7 3 7 7 0 4 5 6 2 6 6 3 9 7 12 13 5 27 22 26 30 29 14 32 18 16 26 20 17 28 22 22 11 30 22 39 26 29 19 17 10 6 20 13 14 18 29 17 21 24 18 17 22 23 24 25 36 27 6 23 15 16 43 20 19 18 25 24 22 25 28 32 21 18 19 
3072 64 48 48 24 24 5 1 7 4 2 7 0 2 7 0 0 6 7 4 0 1 6 6 5 20 17 15 20 20 7 23 8 6 18 3 13 17 20 16 26 34 13 12 26 24 28 31 31 31 13 18 18 16 11 32 23 38 28 20 20 37 19 11 25 2 29 21 21 17 27 36 15 22 27 26 26 29 23 18 11 20 16 18 22 9 
3072 64 32 0 32 8 6 0 0 7 6 5 5 1 3 6 0 1 6 5 5 1 19 13 14 43 9 25 26 22 15 19 23 23 35 27 27 25 30 34 30 41 19 20 36 17 35 30 31 27 14 11 15 7 9 19 21 22 21 24 25 21 20 13 10 24 35 20 24 24 23 13 32 6 23 15 26 15 12 25 12 3 23 31 39 29 
2560 448 16 32 40 32 1 2 7 1 0 7 4 2 7 3 1 5 1 0 0 1 30 32 21 31 5 20 33 29 10 14 11 11 32 18 29 22 28 43 40 39 8 25 26 13 32 24 11 17 25 25 26 18 20 28 33 28 26 43 42 27 19 31 15 21 38 32 25 20 29 9 22 24 15 12 20 16 21 23 12 12 42 25 35 17 
3072 448 48 24 40 56 0 1 0 6 1 2 6 2 0 1 0 7 5 6 5 0 22 7 16 29 28 23 35 35 24 24 22 27 19 30 7 22 18 27 18 32 12 17 29 20 25 16 6 15 35 8 17 8 5 29 15 21 30 37 25 28 29 15 28 14 25 18 25 32 29 23 15 33 11 24 27 30 14 26 28 18 27 13 14 20 
3072 0 16 56 32 40 0 0 3 0 5 2 1 0 7 2 1 3 3 4 6 1 7 2 14 31 34 21 32 36 20 36 25 27 33 11 22 9 18 11 19 24 21 26 38 21 26 18 22 20 17 18 15 17 22 10 20 13 27 25 33 32 28 32 9 31 21 30 19 29 23 17 20 27 34 21 11 26 25 34 18 23 25 16 30 20 
2560 0 40 24 24 56 5 7 3 3 4 6 1 5 3 5 0 7 5 0 4 7 10 21 26 40 31 33 32 21 16 22 21 17 31 27 32 30 24 6 19 37 17 9 44 22 24 13 19 15 37 10 22 26 7 18 6 23 26 8 20 11 18 22 16 14 34 18 18 13 20 18 27 16 18 3 23 15 30 20 6 27 21 33 16 13 
3072 64 0 8 0 24 7 7 2 4 3 5 1 2 7 8 2 5 7 7 7 1 7 7 15 16 15 24 22 33 18 27 16 15 17 21 19 17 17 13 17 15 20 32 47 36 26 22 23 25 17 17 6 16 9 19 2 23 15 20 18 9 36 31 36 27 42 37 24 32 14 27 14 16 14 14 22 16 18 30 18 0 18 11 26 33 
2560 448 8 56 48 16 2 7 3 5 3 4 0 3 4 7 0 5 0 1 5 7 7 30 1 17 11 18 29 24 6 12 7 2 9 8 14 22 17 13 17 22 25 22 18 29 20 15 20 16 36 8 26 20 7 16 0 16 41 40 32 34 28 24 21 32 23 15 15 26 22 26 32 25 27 23 30 19 30 31 32 29 22 26 30 21 
3072 64 48 24 8 8 2 1 2 2 7 4 1 8 2 4 0 4 3 2 0 5 18 25 27 13 13 14 27 26 30 38 22 21 35 21 25 22 29 23 34 32 9 19 22 38 25 17 20 15 21 15 19 11 23 16 2 2 34 16 30 18 21 25 24 25 32 41 23 36 5 8 20 10 13 21 17 12 24 19 21 25 21 16 10 6 
2560 0 24 32 32 16 6 3 5 7 3 3 7 2 5 4 2 5 7 7 5 1 14 28 23 36 14 16 26 25 24 28 23 17 24 25 33 5 12 28 17 24 31 17 29 46 16 20 15 18 30 24 29 23 3 10 9 26 20 18 24 19 24 29 13 15 34 19 24 8 20 27 26 30 18 20 33 25 32 13 22 16 25 13 22 3 
2560 448 8 24 8 40 3 4 5 6 6 6 3 3 5 7 6 1 3 0 0 6 8 30 25 45 22 27 29 36 2 31 15 24 25 13 16 15 25 34 29 26 7 24 19 10 23 30 20 27 34 22 24 23 24 36 13 13 14 8 31 23 30 18 25 24 27 13 29 17 20 33 20 29 20 8 24 15 34 46 35 47 28 21 21 18 
2560 384 0 40 24 8 3 4 2 1 6 7 6 2 5 1 6 5 0 3 0 2 5 31 14 26 16 30 37 34 14 32 8 21 21 2 25 25 9 19 19 20 13 29 34 29 25 23 12 7 27 15 40 18 13 24 16 38 21 17 29 25 17 17 12 26 39 32 36 20 36 28 20 26 28 25 28 29 22 16 24 22 36 25 22 20 
3072 0 8 8 8 32 7 7 7 4 7 3 4 5 4 5 6 6 6 3 2 0 11 15 31 20 21 16 24 27 8 7 3 9 20 28 18 26 27 35 39 36 8 19 25 10 31 29 19 29 17 14 27 25 14 20 20 24 34 21 42 51 15 29 10 11 26 23 19 27 30 13 26 23 28 31 36 31 16 31 25 22 28 20 22 8 
3072 0 24 16 48 16 3 5 0 0 5 3 3 3 0 3 6 7 4 5 2 3 0 23 21 29 25 15 27 17 17 11 4 13 10 22 17 11 9 26 38 21 19 27 29 29 23 18 20 32 32 17 39 25 0 13 7 31 27 24 16 35 24 26 17 0 18 23 28 24 21 14 24 30 24 29 15 24 18 21 23 19 24 22 22 25 
3072 64 40 24 56 40 2 2 4 1 3 6 0 1 1 7 4 4 0 2 7 6 2 8 0 15 18 12 23 35 7 4 17 19 23 10 18 6 14 36 30 24 3 5 17 16 17 18 21 19 16 3 40 6 9 19 15 28 32 26 34 25 30 26 25 14 30 30 25 34 19 21 7 18 4 13 13 3 34 20 26 16 32 26 30 33 
3072 448 0 48 56 40 4 0 7 5 6 4 4 2 1 6 1 1 7 0 5 2 18 22 15 29 16 24 20 25 24 20 16 27 35 24 21 18 15 15 27 34 11 8 37 24 18 15 40 24 32 0 27 14 6 20 3 13 44 21 43 18 7 19 24 17 25 21 18 30 21 32 37 32 11 26 21 16 33 21 24 16 23 20 22 27 
3072 448 8 48 48 16 4 6 5 0 4 6 6 3 7 3 3 1 5 3 1 4 20 11 21 43 33 25 28 29 11 18 13 14 42 25 31 18 20 29 16 40 14 8 33 31 20 23 8 6 14 12 12 15 14 28 19 28 39 22 28 33 37 26 33 15 32 23 26 16 17 6 19 23 13 22 11 12 8 22 30 5 26 27 19 8 
2560 448 40 8 0 8 7 1 0 7 2 4 0 3 3 7 4 2 7 0 6 0 7 26 24 19 25 10 33 17 41 26 13 35 37 26 42 34 26 34 25 41 13 9 17 16 34 16 22 11 10 7 16 11 2 34 28 14 29 26 32 16 13 36 20 45 45 9 29 27 12 29 36 25 5 17 28 26 23 33 15 20 43 37 39 27 
3072 448 48 32 8 24 0 2 4 0 6 6 5 5 0 7 1 4 5 7 5 1 15 37 27 36 14 27 26 36 31 21 20 26 32 24 25 23 14 5 20 19 23 14 22 24 23 27 46 29 19 21 27 25 16 30 13 32 14 10 34 26 18 20 12 18 12 15 17 23 31 18 19 35 23 16 37 34 19 36 30 16 23 31 21 23 
3072 0 48 0 40 16 0 3 1 4 6 6 5 7 1 0 3 3 6 0 3 4 12 15 16 22 13 14 26 22 23 20 7 31 27 34 29 19 12 10 15 27 18 14 23 13 44 20 31 22 23 8 17 20 4 27 35 28 34 21 19 22 20 40 30 32 42 17 21 33 31 18 5 29 23 3 27 7 19 26 21 15 33 20 27 27 
3072 0 32 24 32 16 3 0 7 5 6 7 5 3 0 4 4 0 6 7 1 5 14 16 14 26 16 5 36 16 23 29 30 39 19 31 41 24 9 16 22 23 17 20 30 11 27 34 21 21 15 19 22 16 3 19 5 37 30 3 39 18 30 25 14 9 34 20 22 19 33 35 27 33 23 22 25 10 14 15 18 12 23 20 24 25 
2560 0 8 56 0 40 1 2 7 6 5 5 4 4 4 7 8 7 4 4 6 6 20 14 14 20 22 14 25 20 10 28 3 24 23 23 17 19 14 18 9 29 11 22 24 13 10 16 27 16 20 19 27 20 18 27 6 22 32 40 24 18 20 37 27 23 29 19 17 15 26 14 35 23 22 5 14 15 31 20 23 31 21 20 5 15 
2560 384 56 8 48 0 2 5 5 2 2 5 4 4 1 7 0 1 8 10 4 7 23 22 28 37 23 15 23 41 31 34 32 36 12 17 7 24 19 15 15 25 19 24 39 28 28 33 26 24 36 20 35 23 14 34 19 29 18 14 35 20 11 17 14 19 30 27 16 14 22 16 21 29 19 33 24 22 19 29 27 30 15 25 18 25 
2560 0 56 8 48 8 3 0 0 0 3 4 0 5 6 2 6 0 5 2 6 4 14 25 43 40 9 16 25 15 21 20 16 25 33 23 40 35 18 24 26 24 9 16 27 11 15 27 30 20 34 17 17 18 27 28 17 37 20 27 33 31 24 29 24 25 29 26 31 36 33 14 22 26 24 19 25 29 16 27 23 16 45 20 36 50 
2560 448 40 24 48 40 7 6 5 3 0 0 4 5 2 4 0 2 4 3 0 7 16 22 29 32 26 22 32 26 16 15 0 17 23 22 20 10 17 34 34 34 9 9 26 16 41 41 22 18 22 20 24 24 25 31 13 17 16 16 27 27 22 31 19 23 34 29 13 17 30 38 32 38 7 22 23 12 25 18 33 17 29 17 22 10 
3072 0 24 40 0 16 2 4 4 5 1 5 5 5 1 4 7 2 1 1 4 7 3 23 18 39 9 24 19 19 14 20 15 12 26 17 37 40 8 16 23 29 7 0 16 11 23 26 20 6 12 8 14 22 26 15 24 22 22 17 33 21 41 42 14 45 31 28 20 14 31 8 20 26 20 16 10 14 36 36 35 34 26 26 27 20 
3072 64 16 8 16 0 7 0 1 4 4 5 1 4 1 6 2 3 3 2 0 4 7 31 25 19 9 24 38 30 19 21 11 24 12 4 29 10 38 20 44 24 12 26 23 21 35 23 34 34 15 8 20 21 7 17 12 20 36 32 25 31 22 30 26 36 28 5 29 9 24 5 12 12 21 26 32 36 22 19 19 14 26 21 19 11 
2560 448 48 32 0 16 6 5 1 1 7 7 2 7 7 4 0 0 5 2 6 6 22 16 14 25 8 25 36 29 19 20 18 20 30 24 21 13 13 18 31 20 23 18 29 19 18 28 29 21 22 2 13 11 4 19 13 19 24 17 18 22 15 30 23 28 34 22 29 20 17 35 26 43 23 27 27 33 32 31 36 44 37 31 19 16 
3072 64 0 8 8 0 0 3 2 3 4 5 1 4 5 2 3 3 6 1 4 2 15 23 12 24 22 29 15 21 11 17 4 12 15 13 21 25 16 6 5 22 14 13 32 7 26 31 29 16 28 5 14 19 16 12 23 20 23 38 20 35 26 24 18 29 27 40 20 14 28 37 6 20 25 22 34 25 19 31 32 20 40 20 27 28 
3072 448 40 56 8 48 2 4 7 1 2 0 1 2 0 7 0 1 5 1 6 1 9 24 2 15 26 28 38 36 5 10 8 19 18 5 23 11 20 12 13 28 19 8 26 26 24 21 26 21 23 19 19 2 26 29 7 19 10 24 22 10 16 14 19 38 30 32 19 15 34 31 12 26 22 17 30 10 17 23 9 18 33 8 19 16 
2560 448 32 56 0 40 4 0 5 7 5 6 7 1 2 3 4 7 0 3 0 5 15 7 8 21 21 12 33 24 15 19 19 22 34 26 33 36 27 18 23 28 18 20 37 22 26 28 29 17 19 9 23 17 18 25 14 18 21 26 27 12 13 29 22 32 21 17 45 32 24 21 17 35 14 19 23 13 26 35 42 17 8 10 14 6 
2560 448 0 8 0 32 3 5 2 3 6 2 7 3 3 6 6 4 4 5 1 5 6 3 19 16 11 19 19 17 36 43 32 52 31 23 26 27 27 21 22 37 25 21 30 13 24 16 24 25 17 17 32 16 17 13 0 17 33 17 29 15 11 34 16 17 33 19 32 24 20 30 27 18 22 15 18 17 31 25 12 19 32 46 36 31 
2560 448 0 0 0 56 2 1 4 5 1 1 6 0 2 3 2 7 6 2 1 2 19 20 31 36 9 16 26 26 9 17 20 18 27 16 21 25 17 19 19 18 33 13 30 15 17 14 21 14 31 20 40 16 21 33 24 34 23 33 35 34 27 32 5 32 33 18 18 21 35 31 26 34 28 29 29 23 20 36 17 17 31 29 19 19 
2560 0 48 48 16 8 0 5 5 5 1 3 0 7 2 5 2 6 1 0 6 0 21 24 30 36 9 5 22 28 7 29 8 21 46 22 28 30 11 11 6 37 27 18 34 35 22 33 18 24 29 11 35 25 15 33 12 11 49 28 29 30 15 22 9 18 26 20 24 28 21 7 11 15 15 15 34 12 19 32 6 16 16 32 34 26 
3072 448 40 40 32 48 1 4 4 2 1 4 3 5 1 4 0 2 0 3 5 3 3 11 26 27 20 17 28 29 2 26 14 10 29 30 19 22 18 19 25 36 20 19 15 13 24 8 24 20 24 26 30 24 18 24 12 32 34 7 31 22 25 27 18 25 19 11 14 5 15 25 25 15 27 17 22 26 24 39 28 28 31 18 30 9 
2560 384 16 24 32 48 7 3 5 4 3 2 5 4 5 6 4 5 3 1 0 2 10 16 10 17 31 23 17 31 41 33 26 21 26 10 28 32 7 26 13 32 36 21 44 23 28 25 41 18 20 9 27 14 18 28 28 23 34 21 29 38 19 14 21 13 28 26 14 19 20 13 13 24 32 27 28 22 28 38 33 15 12 29 25 35 
3072 64 40 0 56 40 6 4 1 2 1 6 3 0 5 2 2 7 7 0 3 4 9 15 18 20 19 8 25 33 13 16 20 6 30 17 18 14 21 12 8 28 11 12 30 12 32 37 24 39 23 24 32 15 22 39 13 23 26 28 21 24 5 37 13 18 22 18 20 27 14 18 13 18 13 9 15 4 28 28 19 22 22 20 14 17 
3072 128 56 56 24 56 7 1 6 0 2 0 1 3 3 4 5 0 1 1 0 7 20 16 32 28 17 17 19 21 12 18 17 29 19 22 27 18 11 29 25 27 25 17 30 27 22 18 23 15 20 16 19 17 22 38 23 33 14 22 26 17 25 26 24 24 34 16 25 15 4 10 18 27 16 15 38 28 26 32 12 21 22 25 11 30 
2560 448 40 8 48 40 1 1 0 2 0 7 3 4 11 2 4 1 5 1 6 0 16 10 18 29 11 18 30 30 2 10 0 13 27 33 21 40 18 19 15 21 11 9 30 13 27 46 32 33 28 18 20 16 14 35 17 19 16 22 16 21 24 31 21 39 14 11 27 7 33 26 15 27 25 19 28 24 18 26 9 17 51 36 37 12 
2560 384 40 16 8 16 7 2 3 2 2 6 3 1 7 3 7 7 5 1 3 3 12 8 13 24 19 15 38 31 11 26 22 12 40 25 33 27 23 22 20 27 14 15 33 23 30 26 24 15 32 35 26 22 40 33 18 28 13 30 37 35 18 25 36 30 24 11 17 24 22 29 25 25 23 30 38 19 23 26 15 10 29 22 14 37 
2560 448 40 56 56 0 4 7 4 6 6 7 6 2 0 0 7 4 2 2 3 4 11 15 17 21 4 11 26 30 13 35 8 38 16 14 25 28 23 22 24 27 20 6 41 16 22 29 29 22 35 24 34 20 25 29 14 26 25 29 23 28 22 25 20 7 26 10 19 15 32 29 29 16 42 44 20 27 28 24 7 24 27 24 26 19 
2560 0 16 24 16 16 6 4 3 6 0 5 3 4 4 4 4 4 5 0 3 12 8 13 20 29 7 17 26 18 24 42 11 28 37 28 35 29 10 21 24 20 22 17 28 15 33 35 30 22 36 27 25 31 11 29 19 44 36 17 39 35 28 20 21 31 34 47 24 28 23 4 28 27 17 22 23 15 26 38 20 15 41 23 28 18 
3072 448 24 24 48 16 2 6 4 3 5 0 3 7 10 2 2 3 6 4 7 2 17 16 11 43 12 18 27 30 6 22 13 26 26 30 24 25 14 11 31 25 21 16 19 20 34 26 37 35 31 23 15 15 18 25 21 35 33 32 28 19 9 33 19 27 45 11 13 18 46 26 25 37 27 19 30 18 21 33 19 16 29 31 24 20 
3072 0 0 0 16 56 3 3 0 4 4 2 5 4 3 2 3 5 6 4 3 2 24 20 15 27 21 18 39 30 24 26 18 16 33 30 27 29 22 22 36 37 25 9 43 26 36 32 34 21 35 8 30 9 33 18 8 20 25 33 35 34 5 27 4 28 18 16 22 17 27 32 33 25 14 30 21 20 18 33 16 19 33 15 15 20 
2560 320 32 24 32 56 0 5 7 1 1 7 6 5 4 3 1 5 1 5 1 5 10 17 13 26 22 21 24 22 22 26 20 35 22 39 26 36 19 26 27 34 30 26 24 22 29 24 13 17 28 32 11 23 26 28 6 28 22 38 43 40 23 23 5 15 35 27 27 38 34 26 25 24 12 5 26 11 37 27 32 26 30 12 18 5 
2560 384 48 40 40 48 1 1 5 0 7 6 4 3 3 5 4 2 7 2 1 0 16 8 7 18 0 9 23 13 33 18 13 30 34 14 23 21 32 24 33 43 28 12 32 24 28 28 26 38 23 23 32 29 9 14 8 8 33 12 33 14 28 32 10 18 22 25 8 17 33 36 21 30 25 21 22 26 28 16 23 19 38 26 37 25 
3072 448 0 56 40 24 6 2 5 0 5 0 2 5 6 6 3 5 4 7 3 0 20 16 24 21 28 29 29 27 24 19 15 28 23 22 26 33 18 10 15 26 24 8 31 29 21 17 23 20 27 32 29 10 19 20 21 7 16 20 17 28 18 26 8 10 20 17 17 23 13 12 18 29 8 11 17 17 42 40 19 17 18 25 22 18 
3072 128 16 24 48 8 7 6 0 4 4 5 6 7 5 6 5 3 3 5 2 3 14 17 17 38 7 0 21 19 12 21 1 14 13 17 17 18 5 21 22 42 12 8 11 23 12 16 23 16 27 17 28 15 18 17 13 9 18 19 24 29 32 41 17 29 34 34 15 30 28 25 32 28 28 19 40 19 16 36 27 17 39 23 35 26 
3072 0 0 24 0 0 7 7 4 7 0 6 6 6 6 2 6 1 7 4 2 6 23 31 22 17 15 19 25 42 27 22 25 23 31 36 22 27 22 20 17 26 13 17 26 23 3 8 23 17 26 31 25 31 29 12 27 25 16 3 20 6 21 26 14 17 31 16 10 14 15 21 16 28 8 17 15 22 12 27 17 11 33 23 11 15 
3072 0 48 24 56 24 5 4 2 6 6 6 2 3 5 3 7 7 2 3 7 1 7 7 6 25 26 20 43 34 23 18 19 26 21 14 18 14 33 28 31 33 24 9 33 14 24 32 12 22 23 22 21 14 1 22 5 19 20 23 44 33 28 38 7 22 31 21 19 22 25 24 32 21 7 17 23 11 29 20 26 7 27 39 33 35 
2560 0 24 48 32 0 2 1 7 5 1 6 6 7 5 4 7 3 10 7 0 6 9 15 4 20 6 16 23 18 11 6 8 6 26 6 17 10 14 24 33 22 17 18 16 15 22 14 18 18 15 15 27 18 18 30 24 27 23 25 33 14 24 33 8 36 27 39 37 31 20 19 20 26 26 10 23 17 28 26 31 22 42 17 27 32 
2560 448 56 32 24 24 4 4 0 4 1 0 6 2 6 7 7 0 3 5 4 7 5 21 24 26 10 34 26 28 6 22 18 33 25 34 39 23 31 31 25 43 26 18 29 20 29 19 28 19 18 10 20 7 29 23 33 30 3 19 15 22 36 27 29 16 37 27 24 28 20 16 24 32 17 17 21 28 20 39 26 36 28 21 21 3 
3072 0 24 24 32 8 0 5 4 2 0 4 6 4 5 2 5 6 6 3 0 1 23 18 22 15 24 18 18 20 18 11 13 10 16 28 26 25 13 15 14 28 33 10 35 18 24 33 19 11 17 20 22 27 10 29 26 25 10 32 40 27 24 18 26 23 28 19 22 29 25 25 32 38 25 14 32 12 22 26 18 21 22 29 32 21 
3072 384 56 0 0 8 2 0 0 5 2 7 6 6 1 4 3 2 6 11 6 0 35 13 27 15 19 35 32 25 12 21 19 17 42 30 27 23 29 17 33 33 12 7 22 35 19 22 31 25 22 32 7 26 21 22 6 25 31 22 21 28 19 23 17 20 37 43 37 34 28 22 12 25 14 20 14 33 43 35 33 34 21 37 30 16 
2560 448 56 32 40 0 5 3 6 4 3 1 5 7 2 1 3 2 5 4 2 2 5 29 14 14 28 33 35 45 21 33 2 12 31 29 20 31 34 11 24 31 23 10 21 22 25 37 25 32 25 25 32 34 17 24 19 35 30 21 29 20 13 14 25 25 26 24 7 30 37 46 32 25 26 13 19 14 33 26 23 25 20 21 14 6 
3072 0 24 32 32 56 4 1 6 4 5 3 3 0 6 4 2 1 1 5 3 4 28 28 30 37 23 20 22 38 25 24 22 28 22 12 14 27 17 3 23 15 12 9 30 15 28 32 36 26 24 10 11 22 6 14 18 19 35 22 33 10 4 20 21 16 32 33 25 26 34 18 27 29 25 25 31 22 16 15 28 23 27 31 17 30 
3072 0 24 8 56 8 0 2 1 7 4 6 6 6 7 1 0 8 1 1 1 1 11 20 17 28 13 10 24 24 6 21 22 21 18 13 9 25 28 27 27 39 19 10 32 20 15 20 27 33 23 13 29 10 19 38 11 27 22 22 21 25 29 30 23 15 28 32 26 18 5 18 27 17 22 22 27 21 22 35 19 17 22 19 14 12 
3072 0 24 24 40 8 3 6 7 3 6 5 0 6 5 0 5 6 1 1 1 3 11 12 28 20 4 18 34 26 10 27 5 25 28 23 19 27 4 30 13 23 24 31 37 16 23 17 31 42 21 8 25 19 13 20 4 17 23 16 23 28 12 18 19 35 28 20 23 22 20 24 15 22 27 10 35 32 32 29 20 32 19 20 32 9 
2560 384 40 8 32 16 2 7 5 6 0 7 4 5 2 4 1 0 3 4 2 2 3 22 8 24 16 34 17 25 16 35 25 12 24 18 17 17 28 19 24 31 19 8 40 23 43 28 20 29 25 3 27 20 11 31 20 23 24 30 17 22 39 28 16 30 18 10 28 22 30 39 31 37 20 26 41 36 21 30 25 15 34 36 45 38 
3072 128 0 8 40 32 3 6 6 1 7 2 5 3 0 2 3 2 2 1 0 4 20 11 23 38 19 14 27 25 15 21 5 14 26 18 19 8 10 13 18 23 12 14 24 21 29 26 16 30 20 16 15 9 3 13 4 12 22 21 28 11 0 15 16 14 28 24 23 26 28 26 23 24 13 17 21 13 22 32 23 25 36 13 21 14 
2560 384 40 32 48 56 2 7 7 1 0 2 7 2 7 1 4 4 4 6 5 3 9 14 24 34 16 28 24 42 27 39 17 30 19 18 15 23 11 22 17 32 20 23 28 26 32 20 31 31 21 0 21 15 9 11 24 31 32 33 49 36 35 37 40 13 17 32 18 17 26 24 23 35 14 26 17 15 28 47 16 22 25 36 40 32 
3072 0 32 56 48 16 3 1 7 7 6 2 1 3 7 3 1 7 5 4 6 4 11 5 0 23 6 14 22 1 9 18 13 21 25 14 19 11 15 25 16 18 29 32 37 36 37 28 31 13 7 12 19 18 20 32 22 23 12 18 14 21 18 20 24 11 25 18 29 31 24 20 28 24 19 30 22 17 28 30 33 34 22 25 50 18 
2560 0 8 32 40 48 5 1 0 5 6 3 1 7 1 5 5 4 2 4 2 4 18 22 11 26 11 3 35 32 24 26 19 29 16 20 19 4 16 8 21 30 23 20 27 14 24 9 19 15 15 18 24 8 16 15 12 18 2 33 22 35 9 30 14 22 18 14 23 25 31 34 20 34 29 25 22 25 34 35 36 22 33 11 24 13 
2560 64 8 48 0 0 3 0 5 1 2 6 3 1 2 7 4 1 2 0 3 0 26 31 22 28 23 26 30 35 15 25 24 32 21 13 19 15 26 30 42 31 16 21 38 21 20 11 15 10 24 13 26 33 8 25 18 27 12 12 16 7 28 38 22 27 26 13 32 21 25 20 28 25 19 21 32 23 26 25 11 22 28 18 26 33 
3072 448 32 56 40 48 5 3 3 3 4 1 2 3 1 0 5 1 2 4 4 2 8 15 7 27 14 12 23 35 14 22 9 16 27 35 30 33 28 22 24 21 4 11 20 5 32 27 11 21 27 30 25 14 6 18 12 22 22 18 17 15 24 28 30 37 18 18 25 30 25 29 31 36 24 28 20 26 20 28 16 14 23 17 39 29 
2560 0 56 16 48 40 1 2 5 7 3 2 5 2 6 7 6 3 3 5 4 6 31 24 18 19 14 6 20 22 11 27 18 12 27 26 30 38 37 19 16 29 22 24 29 21 27 27 20 28 31 14 17 6 24 37 19 27 12 26 16 20 19 27 9 30 29 28 32 35 24 34 14 36 32 5 16 10 21 23 14 20 22 15 33 22 
2560 448 8 32 40 56 5 6 5 5 0 2 3 2 4 7 1 4 7 5 2 6 23 33 12 16 19 7 24 19 20 19 9 19 34 16 27 22 25 21 33 35 17 6 26 27 23 24 30 18 16 0 17 5 19 21 13 23 25 18 38 36 31 32 17 8 19 23 23 12 36 26 32 32 30 25 23 7 23 27 8 8 17 23 29 22 
2560 448 56 40 0 0 7 5 6 2 5 0 0 4 2 3 3 6 4 0 3 1 19 24 15 43 29 16 34 46 14 27 8 8 24 21 21 32 33 35 39 27 17 20 21 6 24 22 30 35 18 11 15 15 5 25 7 17 25 36 15 36 29 28 17 31 25 20 23 21 25 36 21 28 40 29 30 26 10 29 29 19 43 31 32 30 
3072 64 16 0 48 24 2 3 4 3 5 4 6 5 0 2 7 0 5 4 5 1 19 24 24 38 19 7 20 19 18 35 22 18 31 21 12 24 22 14 21 31 19 39 23 26 28 34 22 21 34 18 20 18 28 20 16 11 17 25 16 26 21 32 28 36 25 11 25 18 33 24 3 34 13 1 14 17 12 15 6 9 29 15 26 28 
2560 448 0 32 24 0 5 2 3 3 6 1 7 6 0 1 4 0 5 8 7 3 7 19 21 16 18 23 22 19 28 27 19 16 24 32 24 30 25 16 18 22 28 17 14 29 37 22 39 31 38 19 40 28 12 15 19 23 29 32 22 17 32 39 21 17 24 19 30 35 9 21 12 28 18 16 17 25 28 30 16 30 40 33 30 29 
