2611 799 210 213 231 150 4 0 9 2 1 3 0 6 10 14 2 1 17 12 4 4 0 0 5 3 18 1 3 2 5 14 6 2 7 11 4 3 1 3 3 2 4 0 1 8 12 10 2 5 12 3 2 8 4 0 0 2 13 0 11 8 0 3 2 1 3 0 0 0 3 8 9 9 4 0 19 0 5 0 3 4 20 23 2 5 
2680 718 195 151 239 143 5 4 8 2 2 2 3 4 20 6 4 0 7 8 11 4 0 3 1 0 12 7 0 4 0 14 5 4 12 8 3 4 6 0 1 4 2 0 4 0 7 8 0 10 14 6 6 0 5 10 5 16 7 1 3 1 10 11 0 7 7 15 10 0 6 5 1 4 0 5 20 1 11 15 4 1 16 6 0 1 
2670 729 173 200 236 179 1 0 0 1 5 6 5 9 13 19 3 7 10 5 3 1 5 2 13 3 2 6 7 5 0 17 1 9 0 0 7 5 3 3 2 2 5 0 8 6 19 8 3 15 13 2 2 6 1 6 4 14 10 12 8 15 0 0 5 5 0 9 2 0 7 3 3 11 1 5 1 10 8 3 11 0 14 13 18 1 
2667 811 236 220 189 148 0 4 9 1 1 3 6 14 3 7 2 3 3 3 7 4 0 1 0 11 1 1 6 0 1 10 0 2 0 0 10 10 5 1 7 13 5 0 6 8 3 9 4 0 5 4 0 0 2 7 0 4 9 21 16 1 1 0 1 3 7 2 3 1 0 3 4 13 1 0 2 0 13 0 10 2 13 9 0 0 
2651 841 203 223 199 119 2 2 12 6 5 7 0 2 3 21 2 6 34 7 2 3 0 0 2 2 3 4 3 5 0 13 0 2 3 6 5 0 4 2 0 10 0 0 10 4 4 15 1 2 14 7 0 0 0 0 1 3 9 4 9 6 2 3 0 5 9 6 3 7 2 8 4 6 0 0 17 0 1 0 0 5 9 23 3 0 
2692 818 225 229 254 188 1 0 2 12 1 2 9 4 19 4 4 2 1 6 11 2 2 0 0 12 7 0 1 5 0 19 0 1 7 14 1 3 0 8 0 0 1 0 2 6 1 11 8 6 11 7 7 0 2 14 1 24 8 2 7 8 4 7 0 5 0 3 0 3 0 7 0 12 3 0 12 12 7 5 11 0 25 14 15 0 
2663 878 222 212 233 152 3 2 0 1 10 4 4 12 0 9 1 0 23 24 7 0 0 0 2 0 6 9 0 5 3 4 0 7 10 7 3 2 3 13 15 0 3 1 10 5 19 6 9 0 11 0 10 2 0 4 0 8 16 12 18 1 1 15 0 4 5 2 1 7 6 1 3 6 1 3 13 5 4 3 2 6 13 8 14 0 
2662 645 158 189 236 189 2 12 20 9 8 3 8 17 8 13 6 3 10 25 2 4 12 1 8 2 6 2 1 3 3 0 1 11 12 3 8 5 4 2 6 1 6 8 4 8 2 13 0 4 16 2 10 1 0 0 4 3 16 19 5 9 6 5 0 8 1 8 0 3 21 7 0 16 4 3 15 0 3 0 0 2 2 17 6 0 
2678 843 200 215 225 119 1 1 0 3 10 9 0 2 0 1 2 1 10 38 10 1 4 4 2 9 2 0 0 6 0 18 0 4 16 8 3 3 8 13 1 4 3 0 1 2 6 3 1 3 13 3 4 0 1 7 0 10 0 12 10 4 2 17 1 0 8 5 0 1 0 1 3 1 9 2 0 2 4 10 5 0 17 13 14 0 
2636 777 221 202 224 149 0 5 1 1 7 2 8 0 3 6 4 0 7 2 4 5 0 0 3 11 4 0 10 1 0 11 3 6 1 11 1 7 13 0 5 5 0 1 14 0 1 2 6 1 11 1 5 1 0 0 0 0 2 7 4 2 0 2 3 0 0 1 1 8 6 1 1 16 17 6 14 2 10 4 0 0 10 11 5 0 
2642 829 250 189 226 151 0 0 2 7 2 0 8 8 10 20 3 1 16 15 6 1 2 4 4 0 0 11 1 0 0 2 5 0 7 10 8 6 4 4 4 0 0 1 4 1 16 0 2 0 7 2 10 9 7 6 0 16 4 16 5 1 1 0 0 4 0 0 20 7 0 0 0 21 4 4 14 0 5 7 3 0 17 13 11 0 
2669 729 166 175 240 109 1 2 3 3 3 1 8 5 7 19 2 3 8 16 0 10 1 1 1 4 0 1 11 6 0 3 2 0 5 3 8 0 2 2 3 1 0 0 10 7 12 8 5 6 20 2 2 4 0 4 0 4 9 4 3 3 3 2 9 3 1 1 3 0 6 5 1 6 3 0 27 1 1 4 0 4 15 15 9 0 
2665 891 203 171 195 146 3 6 6 7 1 1 4 6 3 9 3 6 14 22 12 4 0 0 0 10 15 2 18 7 1 14 0 0 12 4 2 0 6 1 7 4 0 0 1 4 0 7 0 5 0 0 9 0 0 1 0 19 5 13 11 0 1 5 0 0 5 0 0 1 0 5 10 14 3 3 8 6 2 1 0 17 12 18 12 0 
2647 841 193 164 210 161 2 3 4 3 2 4 0 12 21 14 0 5 7 31 6 1 1 2 7 0 4 0 5 5 1 0 0 0 9 20 3 1 0 3 0 0 0 1 9 4 9 5 3 8 26 0 2 1 12 8 0 17 4 5 0 1 0 3 0 1 0 5 3 9 11 8 1 25 8 1 16 10 15 0 1 1 18 12 5 0 
2673 731 248 233 258 125 3 10 1 6 16 10 9 18 8 4 1 3 8 11 3 4 1 0 0 6 3 3 7 1 0 10 6 3 5 1 10 1 2 10 5 15 2 9 9 5 5 9 16 3 11 4 1 6 2 2 0 12 0 12 4 0 0 1 5 3 1 2 0 3 13 3 17 5 2 6 9 3 7 0 5 17 2 2 0 0 
2619 716 127 196 209 170 0 4 4 7 3 2 3 0 4 9 6 1 26 0 11 1 1 0 8 1 8 0 1 12 0 15 0 8 10 13 14 3 5 3 1 1 2 1 0 1 11 2 4 12 16 0 2 13 1 2 4 15 4 7 2 7 12 15 0 0 0 0 0 1 0 7 5 10 0 1 10 5 18 4 9 14 21 18 11 0 
2638 800 209 183 153 127 4 4 13 1 0 4 3 25 9 7 9 9 10 13 4 5 3 0 5 5 2 10 2 3 0 20 6 0 15 14 17 5 0 1 3 0 0 2 6 4 8 11 4 11 22 1 5 2 4 4 2 0 4 2 2 1 0 3 2 8 0 2 4 2 0 12 7 9 0 3 18 0 0 9 0 7 19 21 14 1 
2674 707 197 178 196 138 9 3 21 6 3 10 5 4 2 12 2 3 11 7 3 4 3 8 1 0 2 5 6 3 0 4 3 3 11 0 10 0 1 0 1 0 2 2 10 7 1 7 1 10 17 8 5 1 1 0 1 4 4 6 4 0 4 6 0 0 0 0 3 11 10 5 3 10 8 5 2 0 0 6 9 0 7 18 8 0 
2661 764 203 178 207 145 4 9 3 13 1 1 1 6 16 12 2 10 15 5 1 0 0 10 1 5 6 2 1 0 7 7 0 0 8 1 6 10 5 0 0 8 4 0 0 2 3 8 1 6 14 0 8 1 1 4 0 8 7 5 4 4 0 1 3 3 1 2 14 5 16 15 5 14 9 0 12 1 0 5 6 12 7 10 8 0 
2644 828 147 204 259 144 6 5 10 2 3 5 15 3 0 3 1 1 18 12 0 1 11 2 7 1 0 0 1 7 0 8 0 0 0 13 13 6 1 3 2 0 12 6 5 12 9 6 4 6 14 0 3 1 0 4 1 8 12 17 3 0 0 4 2 3 0 2 3 6 5 3 10 1 0 6 13 5 7 2 0 0 4 16 3 2 
2602 908 199 186 195 163 0 12 11 26 6 3 3 3 3 5 9 3 28 0 2 2 3 1 3 7 1 0 0 0 0 14 4 5 19 7 4 17 3 12 9 8 1 0 0 3 11 7 2 10 19 6 10 1 3 12 0 5 3 7 14 0 0 0 1 1 0 1 1 2 12 8 10 19 10 0 15 0 0 4 0 3 22 7 3 2 
2679 876 222 182 220 117 2 9 0 4 8 0 9 1 16 9 1 4 1 5 4 3 0 0 14 0 3 3 1 0 0 4 0 0 2 9 2 9 7 3 10 1 7 0 0 0 2 14 2 6 15 0 1 0 0 1 4 17 0 15 0 0 5 4 2 0 1 10 0 0 8 0 16 0 5 4 7 0 12 0 7 0 9 26 11 0 
2686 830 222 147 203 127 0 0 3 17 2 1 6 6 9 1 12 4 15 4 9 4 3 9 4 3 0 0 0 13 3 6 4 2 1 5 4 12 4 1 0 0 0 0 0 1 11 3 8 10 9 2 4 1 0 3 3 10 1 4 8 0 0 4 9 4 3 6 5 10 10 9 0 14 10 0 26 3 6 0 0 0 8 15 4 3 
2641 890 155 259 240 176 2 8 1 2 0 15 9 15 10 10 6 1 2 13 0 3 0 0 5 4 1 0 0 3 1 7 2 3 0 3 18 1 0 0 7 9 4 6 12 1 7 15 2 3 15 1 0 0 0 3 3 10 3 10 10 2 0 9 9 0 0 9 7 5 7 0 9 10 2 10 9 8 5 0 0 2 19 17 14 0 
2642 818 143 188 223 167 4 0 4 3 3 1 9 4 4 16 3 15 13 6 2 6 1 0 11 0 0 3 3 5 1 0 5 8 10 12 5 0 0 0 8 10 0 1 2 5 11 2 6 1 5 2 2 1 4 1 0 20 12 11 8 10 1 7 1 1 0 10 9 5 7 0 2 6 3 0 5 4 1 0 10 2 8 10 0 0 
2722 708 238 196 223 167 1 10 1 13 0 1 3 4 6 9 3 0 14 2 2 1 2 0 0 10 11 7 8 12 0 17 0 0 10 3 9 3 1 0 2 2 2 0 0 0 5 0 5 13 8 0 3 0 1 2 0 13 0 6 0 4 0 8 3 4 0 3 0 2 2 11 4 14 0 0 22 5 8 1 0 0 13 5 6 0 
2655 875 181 184 196 128 4 2 2 4 2 3 2 4 3 0 3 4 26 14 12 0 3 0 0 12 2 3 11 2 0 10 0 0 0 18 0 2 8 0 7 2 0 1 8 1 6 4 2 6 13 0 13 0 0 4 2 16 10 0 1 18 0 4 0 0 0 0 1 14 15 11 10 13 2 0 15 16 11 14 2 2 10 12 8 0 
2678 796 176 182 176 130 2 3 1 4 2 12 1 0 3 21 3 0 19 26 3 3 2 0 0 2 3 0 13 1 0 15 6 5 2 8 2 0 0 8 9 0 0 3 10 6 0 6 2 0 7 0 0 0 0 1 2 13 7 2 6 2 10 3 6 0 1 3 1 7 12 9 6 9 2 9 0 12 5 11 0 6 3 4 1 5 
2641 723 193 194 257 162 3 1 4 1 0 3 5 7 2 13 6 1 16 2 6 4 0 3 0 4 0 1 8 2 3 10 1 4 0 3 2 10 0 4 8 11 16 0 3 0 8 11 0 6 6 3 4 2 0 12 0 20 16 10 17 13 0 9 5 15 3 0 2 3 4 0 0 32 7 0 5 0 3 13 0 3 11 0 10 2 
2671 730 141 194 195 120 6 0 10 2 5 1 3 0 14 17 4 2 22 0 1 2 1 4 4 4 4 1 8 0 0 5 0 0 5 8 2 0 4 0 5 4 3 2 3 0 4 4 1 10 13 0 0 0 7 1 4 10 0 6 4 13 1 7 0 1 14 6 1 0 5 14 2 5 4 0 9 1 3 0 0 1 16 18 12 1 
2661 685 158 219 241 146 3 3 4 1 3 8 1 13 3 5 7 2 1 6 7 4 1 3 3 1 0 2 2 0 11 0 4 0 5 0 6 0 0 0 8 1 5 4 1 4 0 5 3 7 1 6 6 11 1 0 6 11 9 9 13 1 9 0 4 11 1 10 0 4 3 0 0 3 0 1 7 3 5 1 9 3 13 18 0 0 
2697 778 194 173 186 165 2 2 6 0 4 6 1 4 17 17 4 4 3 14 4 0 2 1 6 0 1 2 7 8 3 24 4 3 0 7 11 1 3 2 0 0 8 3 9 3 11 9 3 21 9 13 2 1 5 9 2 9 3 1 9 0 6 2 0 1 0 13 0 7 1 0 3 3 5 0 14 4 0 0 1 0 5 18 7 0 
2625 886 175 189 177 148 2 1 3 0 9 2 10 13 4 20 2 2 25 22 2 4 0 3 3 9 1 2 0 4 0 14 1 4 10 1 10 6 4 0 14 2 0 1 0 5 3 11 0 7 13 5 5 5 0 8 0 17 5 22 2 7 9 11 0 2 14 0 3 7 14 8 0 5 0 4 14 7 0 0 15 1 11 16 8 0 
2722 693 207 153 267 172 2 1 4 4 4 4 6 12 12 10 0 1 6 2 0 2 6 2 5 1 0 0 3 2 2 7 0 1 3 7 1 3 0 0 0 4 0 1 1 0 4 2 1 9 1 20 3 7 0 4 3 17 0 10 5 14 1 13 4 2 3 4 4 8 11 5 3 13 3 11 6 0 3 0 2 0 3 9 0 0 
2667 921 175 180 221 109 3 9 16 0 5 11 9 11 5 20 0 3 12 16 0 3 3 12 1 3 3 1 7 1 0 1 0 1 4 5 0 0 2 0 11 3 1 2 0 7 7 5 0 6 14 11 3 6 0 5 0 20 7 4 9 5 3 4 3 2 7 8 0 0 9 0 0 2 6 8 19 0 1 12 1 0 23 6 10 0 
2674 778 201 263 221 166 4 8 3 7 4 1 2 32 4 26 3 14 15 0 12 3 0 0 1 0 4 0 0 0 2 9 0 1 0 4 11 5 0 0 6 2 5 2 4 4 8 6 0 3 14 0 9 0 0 3 0 16 0 11 3 5 1 4 3 8 2 0 7 3 2 14 0 18 3 6 14 0 14 2 9 4 4 3 5 0 
2674 840 194 248 176 137 1 9 2 0 0 10 4 17 8 22 2 6 7 23 6 3 0 4 0 16 12 2 3 8 0 5 1 0 2 0 8 0 0 1 9 2 4 10 11 1 0 0 0 0 4 1 5 15 8 9 0 18 3 9 7 1 2 9 0 12 8 5 0 2 0 8 0 8 6 9 13 7 9 8 12 2 12 2 0 1 
2641 659 194 216 193 208 3 8 0 6 1 2 12 9 8 12 10 4 4 10 6 4 0 3 5 2 12 4 3 6 0 8 3 1 13 7 0 7 2 1 10 0 13 0 8 0 13 0 3 2 8 8 7 10 0 3 7 20 13 6 12 10 6 5 1 6 3 4 0 3 11 0 4 12 2 4 11 0 8 5 4 6 6 21 0 0 
2607 838 191 221 218 160 2 3 2 3 4 2 1 17 4 10 3 4 5 11 0 3 0 0 7 0 0 0 3 11 0 10 0 0 2 10 13 1 0 0 14 1 0 0 8 1 1 6 5 8 17 0 7 2 2 6 2 23 5 15 0 6 0 8 2 9 0 9 8 4 7 3 2 28 5 13 23 4 2 6 1 0 9 16 15 0 
2656 827 244 209 250 172 3 2 0 3 4 2 5 13 6 21 1 2 9 16 5 5 0 0 1 9 1 3 0 7 0 5 0 2 4 1 5 3 5 3 0 0 2 4 2 5 6 8 0 9 11 4 12 2 0 5 1 14 19 8 10 2 2 4 2 0 8 0 0 0 11 4 0 8 0 0 4 0 4 7 0 0 20 5 7 3 
2675 708 233 239 226 127 4 18 4 5 4 9 12 7 4 1 10 0 4 22 3 2 0 0 1 8 0 2 0 11 1 7 0 3 9 31 8 5 6 10 3 7 2 0 5 7 10 2 4 17 13 1 7 1 0 9 0 12 3 11 11 0 7 0 2 0 1 0 0 5 1 5 0 5 18 12 9 0 0 0 9 0 5 21 0 0 
2674 847 197 234 233 120 2 1 2 8 7 5 2 13 5 22 0 2 24 1 1 3 0 2 5 0 0 0 3 0 1 5 2 6 0 0 13 1 4 4 5 0 5 0 5 15 0 1 0 17 0 0 7 2 3 3 4 5 4 16 2 6 2 1 0 2 5 0 17 5 3 6 2 2 1 2 29 0 2 3 0 6 13 8 5 1 
2659 743 211 236 197 160 4 4 16 7 3 0 7 8 6 21 4 6 22 18 3 7 0 0 0 7 0 0 2 2 0 23 0 4 9 3 11 6 0 2 0 4 0 0 0 0 2 0 4 4 11 8 3 11 0 4 2 12 8 10 6 3 12 9 5 0 7 3 7 6 0 1 7 25 0 4 16 2 0 1 0 0 3 0 0 0 
2670 694 179 232 254 141 4 2 4 6 12 2 5 12 0 14 4 16 22 14 5 4 3 0 20 0 12 0 5 0 9 7 4 2 8 0 1 1 0 1 1 3 0 6 3 0 4 6 3 9 18 10 6 0 5 7 0 9 3 2 11 2 7 4 0 8 3 17 9 8 10 2 8 15 8 12 10 9 0 3 3 2 9 22 5 1 
2660 970 182 218 200 131 7 1 0 12 0 6 4 11 2 18 0 2 13 26 1 8 1 2 3 9 1 0 0 6 0 11 4 8 4 11 11 13 2 1 0 3 0 1 3 2 5 16 0 14 27 6 3 12 0 2 0 5 10 4 2 0 9 0 0 12 2 2 0 7 15 27 4 16 6 3 14 2 0 5 0 8 10 5 0 0 
2687 710 170 205 203 123 2 1 0 4 13 3 14 4 1 1 8 10 27 2 5 0 0 0 3 10 0 7 1 8 0 4 0 2 9 17 1 2 7 7 6 3 0 5 20 1 6 0 0 2 2 0 0 1 0 6 7 9 4 4 7 0 6 0 0 0 1 3 2 12 0 0 4 13 10 5 18 0 5 4 6 0 5 20 8 1 
2682 705 213 195 275 126 4 10 0 3 7 0 0 1 1 3 0 2 8 16 4 0 0 4 0 10 2 2 0 3 2 13 2 0 2 8 9 11 0 18 0 2 0 0 1 0 0 0 0 12 4 0 4 0 6 6 0 13 4 14 3 6 0 1 4 1 0 7 3 7 0 9 15 12 4 0 4 0 0 0 0 0 14 4 1 1 
2851 602 160 279 250 114 1 2 13 7 2 8 8 9 4 7 9 1 27 13 1 4 2 3 5 4 0 1 7 15 4 5 0 6 8 2 3 3 8 1 8 3 4 0 3 7 8 3 1 3 3 1 9 6 3 1 0 11 0 11 5 8 4 0 0 7 0 7 0 0 7 11 5 13 1 6 2 0 10 1 0 0 9 13 12 0 
2651 742 207 223 199 133 4 3 2 1 1 2 11 15 10 14 3 4 9 15 4 1 7 1 0 8 0 6 18 15 0 7 1 2 8 0 7 1 0 0 7 0 3 2 3 1 1 13 6 0 8 6 2 8 11 2 0 12 1 7 10 12 2 0 0 8 1 6 0 0 0 10 0 23 2 3 13 3 10 13 4 0 14 12 3 0 
2781 684 241 166 245 174 4 3 19 0 0 3 9 14 11 17 6 8 13 13 0 1 0 2 3 0 3 9 6 2 4 4 9 1 0 10 5 0 0 4 1 5 4 2 0 0 4 0 1 4 24 0 0 9 17 3 0 8 11 9 18 2 1 6 0 5 5 13 2 0 3 5 0 0 6 1 17 1 1 0 0 9 1 3 7 0 
2642 745 205 196 206 190 9 0 9 3 1 0 1 8 7 4 3 7 30 14 10 1 4 4 9 13 0 0 12 6 3 17 3 4 8 2 4 11 0 0 8 0 0 2 1 6 0 4 7 10 12 8 5 9 0 0 2 14 2 6 1 3 3 9 0 7 0 14 9 11 22 2 3 11 9 4 7 0 0 17 1 0 11 1 2 2 
2649 921 229 149 257 125 0 0 9 18 4 4 5 3 3 5 4 4 24 8 12 3 5 0 0 6 0 0 4 3 1 11 4 7 3 5 12 13 0 1 8 2 2 0 1 2 12 0 7 7 17 0 8 0 0 0 1 11 0 8 8 9 5 1 1 6 3 3 0 0 8 7 2 5 4 1 14 0 2 2 7 8 18 15 1 1 
2685 829 178 200 232 159 4 2 7 2 4 2 3 18 2 22 4 1 15 4 0 2 1 6 2 9 3 3 4 15 7 6 0 5 14 19 10 5 7 0 6 3 0 0 1 3 0 1 3 6 12 6 8 5 10 4 0 2 14 3 13 4 1 0 9 3 0 5 2 0 2 1 6 14 1 6 16 8 2 6 1 0 1 10 11 1 
2693 743 173 182 207 119 4 0 9 1 12 1 5 2 3 13 0 4 31 25 15 4 0 0 0 0 0 0 5 3 0 5 1 3 15 14 9 12 3 3 7 3 0 2 7 11 0 5 3 18 22 2 3 2 5 4 2 14 1 3 2 8 1 0 0 0 9 1 7 7 1 4 3 20 1 12 11 0 0 9 12 5 8 5 1 0 
2692 730 185 193 193 161 4 7 3 9 0 3 4 17 0 24 4 12 6 19 3 2 0 3 2 0 0 1 5 6 1 5 1 0 1 14 0 0 0 5 0 0 2 14 0 2 6 6 4 8 17 7 8 7 3 1 0 5 2 6 0 13 1 0 1 1 5 2 4 8 0 15 7 9 2 2 9 3 7 3 5 4 5 10 4 0 
2657 768 197 196 168 185 5 3 1 2 1 4 3 22 1 9 5 1 11 8 1 3 3 3 0 1 0 0 3 0 1 8 2 1 13 1 5 11 9 9 10 0 0 0 3 1 2 5 3 0 17 0 17 4 6 0 0 11 4 5 3 3 4 0 2 3 0 2 3 0 6 1 2 17 10 0 15 0 0 6 1 2 21 12 15 3 
2667 769 199 199 198 169 5 1 6 4 1 0 7 7 0 13 4 4 11 19 7 2 0 2 0 9 4 2 0 6 13 2 1 7 16 0 0 4 6 1 6 3 0 0 11 11 6 2 5 2 18 0 1 0 0 10 1 9 13 8 3 3 3 0 0 5 0 0 1 0 3 13 3 7 8 1 13 9 0 9 11 0 12 11 12 2 
2602 673 186 232 252 185 4 5 13 2 11 8 7 8 8 10 4 8 7 9 0 4 3 4 3 2 1 5 0 10 5 17 0 6 13 1 9 8 3 0 0 0 2 2 0 5 3 2 2 6 15 2 11 1 6 3 2 18 7 19 2 8 0 3 2 0 17 10 0 3 0 27 1 1 4 10 13 0 1 4 0 4 30 23 29 1 
2642 709 229 202 240 118 1 2 3 10 9 4 7 10 12 15 16 2 11 11 4 3 1 2 1 10 0 0 1 16 0 14 0 3 14 7 11 5 3 0 10 1 2 0 3 3 17 14 4 7 8 8 0 3 3 4 0 5 7 10 11 6 1 9 3 8 7 4 2 7 2 0 0 9 2 6 8 0 5 4 12 2 14 7 6 0 
2644 810 221 146 179 169 3 1 4 4 3 4 9 3 1 5 2 7 25 29 6 6 0 2 2 5 0 0 11 9 0 14 0 10 6 6 0 2 14 3 10 1 0 0 0 0 5 12 4 13 15 0 7 1 0 2 0 8 4 17 8 0 3 19 0 0 4 2 5 4 0 10 1 7 8 0 19 1 8 2 4 3 18 17 10 1 
2695 722 169 211 219 145 0 4 0 1 1 2 6 28 7 13 4 1 28 8 8 4 0 0 2 16 1 2 6 10 0 17 0 5 0 0 1 3 1 4 1 8 2 0 7 4 7 6 1 5 12 9 6 0 0 9 0 13 0 0 4 12 0 0 0 0 5 0 11 0 8 0 5 19 2 6 13 13 7 4 1 1 4 20 1 0 
2655 726 213 199 200 179 4 11 5 6 13 4 0 15 33 13 5 4 29 2 5 6 0 6 0 4 11 3 1 1 1 12 4 0 15 13 8 5 0 5 4 2 3 0 4 0 7 6 1 3 15 10 2 5 0 2 5 12 1 9 1 5 0 8 8 0 3 9 0 3 3 14 1 19 5 0 16 1 1 0 10 7 12 21 8 1 
2853 893 186 197 244 157 3 7 10 11 1 7 5 5 2 2 5 7 23 20 8 0 0 4 1 3 0 0 3 6 14 12 0 1 3 17 0 4 4 6 3 4 0 8 3 3 10 4 1 0 8 4 1 0 3 4 0 11 0 4 1 1 2 2 6 3 0 1 6 10 6 10 0 5 3 0 24 7 3 4 3 1 2 5 0 0 
2675 714 244 171 208 178 2 1 10 0 2 3 3 9 8 8 2 3 21 5 3 4 2 7 0 6 1 0 0 4 2 20 3 0 12 2 15 2 1 0 3 0 0 0 0 13 5 13 1 7 10 0 0 2 0 6 0 16 12 6 7 4 2 2 6 4 1 1 9 12 6 6 1 9 2 1 15 0 5 0 3 0 6 4 8 0 
2640 650 214 250 249 159 0 3 4 13 4 8 10 4 8 11 3 7 8 4 5 2 8 2 1 7 4 0 11 9 2 3 0 0 3 2 3 1 9 8 17 12 6 1 7 4 14 0 0 11 3 0 0 0 8 5 2 9 6 13 9 9 1 9 1 0 6 3 0 9 7 4 7 13 9 5 14 0 6 3 0 9 10 13 0 0 
2660 803 189 206 228 184 1 9 5 2 7 7 5 7 1 6 4 2 13 24 4 4 0 1 5 0 2 0 5 0 1 6 3 1 0 19 4 12 3 5 4 9 2 0 2 5 9 2 6 1 12 3 0 3 3 3 0 11 5 3 2 1 9 14 2 2 18 0 7 1 0 2 3 19 4 1 20 1 4 2 1 0 14 7 6 5 
2670 737 220 174 232 138 1 3 16 6 3 3 7 0 0 1 2 3 4 9 2 3 0 2 1 6 0 2 0 9 0 14 1 10 16 3 8 0 0 6 11 0 3 11 0 0 9 7 9 6 13 0 3 1 1 6 4 4 3 3 2 9 9 1 3 2 1 0 0 5 0 0 3 10 0 4 20 4 9 8 2 0 25 12 0 0 
2674 736 233 216 226 184 3 0 17 11 1 2 2 6 3 20 4 4 3 0 3 2 7 0 0 6 0 2 0 7 6 6 1 2 17 10 0 14 0 0 7 2 0 1 5 2 8 19 4 17 7 6 9 7 0 0 5 9 11 13 6 4 2 2 2 9 0 0 7 8 17 7 4 13 4 0 6 0 0 0 0 2 9 2 0 0 
2663 783 182 171 205 142 9 4 5 7 0 1 3 2 5 5 1 6 21 4 4 3 0 5 0 0 0 3 9 9 2 15 1 2 3 10 3 1 3 0 0 3 2 0 6 6 8 11 0 10 22 1 5 7 1 0 0 14 0 14 7 7 0 7 1 2 0 15 4 8 0 0 10 17 0 1 6 4 9 6 1 2 9 19 0 0 
2699 888 204 187 274 153 0 0 5 8 5 7 1 23 3 9 11 13 19 20 17 3 2 2 0 9 5 2 9 3 0 9 7 3 12 23 8 6 0 2 9 0 0 0 5 12 1 0 4 16 17 0 3 2 0 5 0 13 6 10 4 16 3 3 5 0 5 0 7 3 11 15 7 18 3 0 14 6 0 7 3 6 7 4 1 0 
2661 711 221 213 181 161 2 1 10 8 0 0 11 18 3 6 10 4 10 24 8 9 0 0 1 2 0 6 0 4 1 7 2 3 11 17 8 1 1 3 11 0 3 5 7 7 2 12 5 19 21 4 6 1 0 2 0 17 2 12 5 5 4 5 8 0 1 10 3 0 8 7 0 14 6 4 11 8 0 1 2 0 7 9 6 0 
2661 815 260 216 265 112 10 7 26 9 4 1 1 18 14 14 2 5 18 22 8 4 0 0 5 7 5 1 7 9 9 10 7 5 6 9 7 10 4 4 6 8 0 0 15 0 1 3 1 18 5 0 6 3 0 1 9 18 5 17 1 5 0 3 0 2 0 8 9 4 0 7 3 3 5 8 31 11 2 5 4 0 1 2 2 0 
2664 827 204 218 175 157 2 7 12 14 3 1 3 10 10 30 0 4 4 20 8 2 3 3 3 1 2 0 7 15 0 0 0 0 0 5 2 2 3 0 5 1 18 0 7 0 1 2 6 6 12 4 9 10 3 2 0 10 0 6 3 2 0 12 2 6 4 5 0 0 0 6 7 7 17 9 11 0 7 1 5 0 2 11 5 0 
2677 733 187 215 129 186 1 2 7 2 20 7 5 2 10 13 12 1 13 10 2 0 0 0 7 3 9 5 13 1 0 1 0 13 17 8 9 4 6 3 6 0 0 0 1 11 6 0 3 0 11 0 7 2 9 19 15 16 4 8 3 16 0 4 0 4 1 6 2 3 0 1 3 6 2 6 12 0 2 6 6 0 17 7 12 1 
2607 726 176 218 258 170 0 3 3 3 4 4 6 13 5 9 4 6 23 10 3 1 3 5 0 9 1 0 2 4 0 12 4 13 14 2 13 2 2 1 0 3 2 3 7 2 0 0 3 5 10 5 2 6 0 6 1 24 11 18 3 0 3 12 0 7 0 11 20 11 5 3 3 12 0 0 5 2 1 4 13 3 20 31 10 0 
2626 694 177 200 248 125 4 4 1 9 4 4 8 5 8 25 1 4 2 9 3 0 0 0 0 5 8 1 2 7 3 7 0 1 13 1 9 7 1 0 3 0 0 1 0 1 0 4 2 10 12 1 0 0 12 3 0 14 14 12 18 7 2 7 0 4 7 0 0 0 1 13 1 0 0 2 9 2 0 0 7 0 17 16 2 3 
2692 788 180 252 270 150 4 14 0 0 0 5 2 4 4 2 4 9 11 7 1 0 5 0 1 0 0 0 16 2 0 10 4 0 14 9 8 4 0 1 10 11 0 0 1 0 11 13 9 10 10 0 0 6 0 6 1 15 0 11 12 12 8 3 3 0 0 6 6 9 1 8 24 11 0 2 3 20 13 0 0 0 5 0 7 1 
2682 892 192 166 195 149 4 4 6 11 10 5 4 8 2 13 10 1 18 9 4 2 0 11 5 2 5 0 5 8 0 16 3 1 7 7 13 12 0 0 4 9 3 0 0 4 17 4 4 3 3 0 0 5 0 4 0 8 6 18 20 8 0 3 0 1 4 10 0 5 13 5 6 9 4 3 16 2 0 0 0 3 25 5 12 0 
2666 729 212 220 269 121 1 3 3 3 5 1 5 11 3 10 3 2 30 4 1 5 0 7 3 9 0 8 0 8 2 15 0 0 10 0 3 6 5 0 12 4 8 1 0 0 25 14 3 22 11 2 4 11 5 4 3 24 0 14 0 10 4 2 0 2 1 11 8 1 6 11 3 12 0 1 14 0 5 1 2 0 7 8 3 0 
2679 743 211 174 224 131 4 6 1 1 1 1 6 1 12 16 7 17 7 24 10 2 5 6 1 2 3 4 0 9 0 4 4 0 8 1 5 12 0 0 2 0 2 3 5 1 14 2 4 9 1 0 2 0 2 3 2 13 19 3 12 8 5 5 11 4 3 7 10 17 2 7 5 9 0 0 2 5 4 14 11 0 5 5 9 0 
