988 64 76 64 80 3 1 3 0 3 3 2 0 1 3 1 0 0 2 1 3 
964 48 88 72 88 0 3 1 3 2 2 2 3 0 0 3 1 2 1 0 2 
984 68 56 68 88 1 2 1 3 3 3 0 0 1 0 3 3 0 1 1 1 
988 76 68 48 56 3 1 1 1 3 0 1 0 3 1 3 1 0 3 3 1 
984 64 60 104 88 1 0 2 3 1 3 2 1 0 1 0 3 2 0 2 1 
980 84 104 80 96 0 2 0 2 3 1 1 1 0 3 0 0 3 2 1 0 
988 52 60 64 88 2 0 1 2 3 1 0 3 1 0 2 3 3 0 2 3 
980 88 100 92 64 0 3 2 1 3 3 1 0 1 2 1 1 3 1 2 2 
988 68 88 92 88 3 1 2 2 1 0 2 0 3 3 2 2 1 1 0 1 
972 52 64 52 88 1 3 2 0 1 1 0 3 2 3 3 3 0 2 3 2 
976 80 76 100 108 0 1 3 3 3 2 3 3 1 2 3 0 3 3 1 3 
992 76 96 64 84 2 0 0 2 0 2 0 2 3 2 3 1 1 1 1 1 
988 64 68 92 96 1 2 2 0 2 0 1 2 1 3 1 1 0 2 1 2 
976 68 48 76 116 2 1 0 3 3 0 2 3 0 0 0 3 3 3 3 2 
980 56 72 60 76 3 3 0 0 2 1 0 0 1 0 0 2 1 2 1 1 
992 52 80 80 80 3 2 1 1 3 3 0 1 3 3 0 2 0 2 0 1 
1000 56 72 80 88 0 3 0 3 3 1 1 2 3 2 2 3 3 1 1 1 
976 52 56 68 88 1 3 0 3 0 0 2 2 0 2 2 0 1 3 3 0 
980 60 68 88 80 3 3 1 3 0 0 3 0 2 2 2 1 3 0 2 2 
1004 72 60 76 80 0 3 2 3 0 2 0 2 0 1 1 2 0 2 3 3 
988 84 48 84 108 0 1 0 2 3 3 2 2 0 1 3 2 0 0 1 1 
992 68 80 56 68 3 1 0 3 2 3 1 2 1 3 0 0 2 1 0 1 
984 60 56 80 60 3 3 0 3 3 0 3 2 0 1 0 3 2 0 3 0 
984 44 68 68 108 3 0 1 1 0 3 3 0 3 0 0 1 3 0 2 3 
968 60 80 100 92 3 0 1 2 0 3 1 0 3 1 0 3 1 1 0 2 
988 40 56 84 80 1 2 0 0 1 3 0 2 3 0 2 3 2 2 0 3 
988 44 80 96 76 3 1 0 2 1 1 0 1 2 1 2 1 1 0 1 3 
976 84 68 68 88 0 3 0 2 3 1 3 0 3 0 0 2 0 0 3 1 
988 72 76 96 72 1 3 2 2 0 3 1 3 2 0 2 0 1 0 3 0 
984 68 60 68 64 3 0 0 1 0 2 2 1 3 2 2 1 3 2 1 3 
964 68 76 92 96 2 2 1 1 1 2 1 1 3 0 3 0 3 3 2 2 
976 72 88 88 68 0 0 1 2 2 0 3 2 2 0 1 0 1 2 1 3 
980 80 96 72 84 0 1 2 3 1 3 0 0 3 2 0 1 0 2 1 2 
976 64 80 76 68 3 2 3 3 0 0 1 2 3 2 2 2 3 3 3 0 
980 68 96 80 72 2 3 3 2 1 1 3 3 0 3 1 2 3 2 0 1 
980 84 80 72 96 3 2 2 1 1 0 3 1 2 3 2 0 2 0 0 1 
992 72 76 108 68 3 2 2 0 3 0 0 0 3 3 0 0 0 1 3 3 
980 76 88 76 92 2 3 3 3 0 2 2 2 0 1 2 2 2 1 0 2 
984 72 80 88 80 2 0 1 1 0 3 3 0 2 3 2 2 2 2 3 1 
984 68 68 92 68 1 1 1 2 1 0 2 1 2 3 0 0 0 0 1 2 
992 80 80 96 68 0 2 1 0 1 0 2 2 0 2 0 0 0 1 3 2 
992 60 72 76 92 1 2 3 3 0 3 2 2 0 0 3 2 2 0 1 0 
996 56 76 84 76 1 1 3 1 1 1 3 0 3 1 2 1 1 3 2 0 
960 68 68 40 80 0 1 3 1 0 2 2 2 3 0 1 0 0 1 2 3 
988 80 100 76 76 2 0 1 2 2 3 1 1 3 3 3 1 3 3 0 1 
992 64 88 88 96 3 1 0 1 3 2 3 0 3 1 0 0 2 0 0 2 
988 72 92 40 88 1 2 3 0 3 1 2 2 2 2 3 0 3 1 3 3 
988 76 80 88 92 1 1 3 0 0 2 3 3 0 1 2 1 0 1 0 2 
1000 64 56 76 96 2 0 1 3 1 2 1 1 2 0 0 3 1 3 1 3 
976 84 52 88 80 1 2 2 0 0 3 2 1 2 1 0 0 1 3 0 2 
976 72 64 96 96 3 2 0 2 0 3 0 0 0 1 1 2 1 0 0 3 
988 56 64 72 76 2 2 0 1 1 2 0 2 2 2 2 1 1 0 2 3 
976 48 72 88 80 0 1 2 1 3 2 3 1 2 3 3 2 3 0 2 0 
996 88 68 60 76 0 0 0 3 0 0 3 1 3 3 0 2 3 0 2 2 
972 88 88 116 72 1 0 3 3 0 1 3 1 0 2 1 3 2 3 3 1 
984 52 108 100 96 3 3 3 3 2 2 0 0 2 2 0 3 3 2 2 3 
964 72 96 88 80 3 1 2 2 0 3 1 2 3 1 2 1 1 0 0 3 
980 64 80 84 72 1 1 3 0 0 2 1 2 3 2 2 3 2 3 2 3 
984 52 76 80 108 2 3 3 0 1 3 2 0 3 2 3 3 0 0 2 3 
988 76 48 100 96 0 0 1 0 2 1 2 3 2 3 0 2 0 0 3 2 
976 100 100 72 88 2 1 0 2 3 1 3 1 2 3 0 2 3 1 2 3 
996 48 56 80 112 0 1 1 0 3 0 2 1 1 3 0 3 3 0 2 2 
988 76 44 92 80 2 3 1 3 2 1 0 1 2 3 1 0 2 0 1 0 
980 68 60 84 92 0 0 1 0 1 0 0 3 1 2 1 2 1 2 0 2 
956 64 64 60 68 0 2 1 3 0 2 0 0 0 3 0 1 0 0 1 1 
972 88 72 72 108 2 0 3 2 0 0 3 1 3 0 0 1 2 3 2 1 
980 60 76 76 92 1 3 0 2 0 3 2 3 1 1 1 2 2 3 1 3 
988 76 80 96 64 1 3 1 2 1 0 0 2 1 3 0 1 3 3 0 2 
984 68 60 80 108 3 0 1 1 2 3 0 3 2 3 0 0 1 0 3 3 
992 68 84 56 72 3 3 3 0 1 3 0 3 0 0 3 0 1 1 2 3 
984 88 52 72 92 3 2 0 3 3 3 2 2 3 0 3 0 3 0 3 0 
996 68 84 52 76 1 2 2 3 2 0 3 3 0 0 2 1 0 0 0 0 
976 56 80 108 72 2 1 0 2 3 1 0 0 1 1 0 0 2 0 1 2 
948 64 80 96 104 2 2 2 3 0 0 1 2 0 0 0 2 2 3 3 2 
996 44 60 60 96 0 0 0 2 0 2 1 3 1 2 2 3 1 1 0 2 
980 92 76 60 92 3 0 1 1 1 2 1 1 2 3 2 2 2 2 2 1 
980 80 44 104 92 2 2 2 2 2 0 0 2 0 3 0 1 2 3 0 3 
972 56 92 88 84 2 3 3 2 0 2 0 3 2 2 1 2 1 2 3 3 
988 80 64 116 76 0 0 2 0 0 0 2 3 2 1 2 0 2 0 0 0 
984 68 80 76 84 3 2 3 3 1 2 2 2 0 2 2 2 2 0 3 1 
