196 508 456 444 452 456 172 180 172 188 180 188 216 208 184 236 180 180 228 204 172 176 2 3 2 1 3 3 0 3 2 3 1 1 2 1 1 3 3 2 2 2 2 3 1 3 3 1 2 0 2 2 1 1 0 2 0 1 3 1 0 2 1 0 3 0 2 1 0 2 1 3 1 3 1 1 3 2 1 3 0 2 1 3 2 2 
192 504 444 460 452 448 196 192 196 192 184 136 224 184 204 172 164 200 200 204 200 184 0 0 2 0 1 2 2 3 3 2 3 0 1 2 2 2 2 1 0 3 3 2 2 3 2 3 1 0 1 0 3 0 3 2 2 1 2 1 0 0 3 0 2 3 2 3 2 1 1 3 3 1 1 1 2 1 2 0 2 3 2 1 1 0 
192 516 456 444 468 444 172 204 176 236 196 180 212 196 184 184 204 184 216 176 176 188 2 2 3 2 3 0 2 1 2 1 3 1 1 1 2 3 1 2 0 0 2 1 2 1 1 2 3 3 0 0 1 3 0 3 1 3 2 2 0 1 0 1 3 3 0 3 2 1 0 1 3 2 2 0 1 2 0 3 1 2 3 3 2 2 
188 508 460 452 440 460 164 172 156 188 208 192 184 184 192 196 184 192 212 176 200 192 2 3 1 1 3 2 0 3 3 3 3 1 2 3 2 3 1 0 1 0 1 2 1 2 1 1 1 2 2 0 1 2 0 2 2 2 3 0 0 0 3 3 0 1 2 2 0 3 1 0 0 0 2 3 2 1 1 0 0 0 2 2 3 3 
192 504 456 444 448 448 160 168 168 208 192 188 196 188 188 196 180 196 216 208 192 196 3 2 3 3 2 2 1 3 1 2 2 2 3 1 2 3 1 3 1 2 2 3 0 2 2 3 1 3 2 1 2 0 0 1 2 3 0 1 2 3 1 0 3 3 3 1 2 1 1 3 0 1 1 3 1 0 1 1 2 0 3 3 1 3 
192 484 464 456 456 448 180 168 160 200 208 172 204 224 196 200 188 192 228 180 196 180 2 0 3 3 1 3 1 0 3 2 3 1 0 3 3 3 1 0 2 2 3 2 3 2 0 2 1 2 3 0 2 2 1 1 2 0 0 1 3 3 1 2 2 1 3 0 4 1 0 1 3 2 2 2 1 3 1 2 3 2 2 0 2 3 
192 508 452 456 460 436 180 184 184 172 160 168 212 192 188 228 200 196 216 212 188 220 3 3 1 1 2 1 2 2 1 2 0 0 3 0 3 2 2 2 2 1 0 0 0 1 1 3 2 2 3 2 2 0 3 0 3 0 0 3 3 1 0 0 1 0 1 1 2 1 2 2 0 3 3 1 0 2 3 3 2 0 0 1 2 1 
196 504 460 448 444 452 192 188 188 224 172 176 176 188 208 188 188 176 204 160 188 188 0 1 3 2 2 2 1 3 0 2 2 0 1 1 0 0 2 3 1 2 1 1 2 2 0 3 2 2 1 2 3 1 1 2 1 2 1 2 2 1 0 0 1 1 0 3 1 1 1 3 1 2 2 2 0 1 2 2 2 1 1 3 0 3 
196 516 464 448 460 456 164 184 164 212 168 168 192 184 192 216 192 224 212 204 188 196 0 0 3 2 0 2 3 2 0 3 1 2 1 1 0 2 3 3 2 2 1 3 2 1 0 3 1 1 3 3 0 3 0 2 3 3 0 1 1 2 2 2 2 2 0 2 0 0 0 3 2 2 0 3 3 2 3 3 1 0 3 0 3 1 
196 520 440 452 468 440 180 200 164 216 160 176 200 216 164 200 172 184 200 212 208 180 2 2 2 2 0 3 1 3 3 3 2 1 1 2 2 3 3 0 3 2 3 0 3 0 0 1 2 3 3 2 2 3 1 3 3 0 2 2 0 3 3 3 2 3 2 1 1 2 2 0 3 3 2 3 0 0 1 2 1 3 0 3 1 2 
192 508 440 464 448 444 192 192 204 228 184 164 216 172 204 228 196 192 220 180 204 196 3 3 0 0 1 3 3 3 1 2 1 2 3 0 2 2 1 3 3 3 1 2 1 2 3 0 3 0 1 2 0 2 2 2 0 1 0 2 2 0 3 1 1 1 3 1 3 0 3 3 2 3 2 3 2 0 2 3 1 1 0 2 0 2 
196 508 460 464 460 464 160 196 192 184 164 160 204 212 200 220 184 188 216 200 176 180 3 3 1 3 3 2 1 2 3 2 0 1 0 3 2 2 3 1 1 0 0 1 0 1 3 3 2 3 2 0 3 1 2 1 0 2 1 3 1 1 1 2 1 2 3 2 0 2 1 2 3 1 1 0 3 3 2 0 2 1 2 3 2 2 
196 492 468 464 452 456 192 188 176 192 180 160 204 172 200 236 224 184 224 192 212 184 1 2 0 3 1 0 2 2 0 1 2 0 0 1 1 2 2 1 2 0 3 1 0 1 2 1 0 2 2 0 3 1 2 3 1 3 1 1 1 3 1 2 3 0 1 1 0 1 1 2 1 1 1 3 0 0 1 2 0 0 3 2 2 2 
196 508 468 444 444 444 180 156 144 188 168 196 220 192 188 196 192 200 216 192 220 196 0 3 0 2 2 3 3 0 3 2 3 0 3 2 2 1 0 2 0 3 2 2 1 1 2 1 1 2 0 1 0 1 1 1 0 1 3 1 3 2 0 3 2 2 3 3 2 1 0 0 3 1 0 0 3 3 3 2 2 0 2 2 0 2 
192 496 460 448 472 436 164 188 176 200 184 176 208 200 224 208 176 200 220 212 200 212 3 0 2 0 3 0 2 1 3 1 1 1 3 0 1 1 3 2 0 1 3 3 2 3 1 3 3 2 3 0 2 1 1 0 1 0 0 0 2 1 2 0 3 1 2 2 2 1 0 3 3 1 0 3 2 1 3 3 0 2 0 2 3 0 
192 500 452 464 464 448 192 200 212 220 180 176 180 196 192 192 192 184 196 184 184 208 2 1 2 0 1 1 2 3 2 2 1 0 2 0 0 3 2 1 0 2 1 0 2 1 2 1 0 0 0 3 1 0 2 3 0 1 2 1 3 2 1 2 1 1 2 0 1 2 1 2 3 2 3 0 2 0 2 1 3 2 3 0 0 3 
192 504 456 460 444 424 184 192 200 180 192 200 192 220 176 204 176 204 212 188 244 200 2 0 2 1 3 2 0 3 3 2 0 2 0 3 1 0 2 1 3 1 2 0 2 2 3 3 2 3 2 0 3 2 1 1 2 1 1 3 3 3 2 1 2 0 2 2 1 3 1 0 3 0 1 2 3 1 3 3 2 2 3 1 2 2 
196 508 464 464 460 452 176 172 192 180 192 192 224 164 180 208 196 168 208 192 204 196 1 2 0 3 0 2 2 3 3 0 3 1 2 2 0 0 2 2 2 2 1 2 3 1 0 3 1 0 2 0 0 3 2 0 1 2 0 3 2 2 0 2 1 3 0 1 3 2 1 0 2 1 2 0 2 3 2 1 1 1 1 3 1 2 
192 492 452 440 460 476 172 196 204 208 176 188 220 204 188 200 200 204 184 180 176 208 3 0 1 2 1 1 3 0 2 2 0 1 1 0 2 1 1 0 2 0 1 1 1 2 0 2 1 1 1 0 0 1 3 3 3 2 3 3 2 3 1 2 3 3 0 0 2 1 2 0 3 2 1 3 1 1 1 3 1 2 1 3 1 2 
200 484 448 448 448 456 168 196 216 220 184 180 196 196 200 216 168 196 232 184 208 208 6 2 2 0 3 3 1 1 3 2 2 0 0 0 3 2 1 2 0 0 3 1 2 0 3 1 2 2 1 3 1 2 3 2 2 2 3 2 1 3 3 1 0 2 0 2 2 1 2 1 0 2 0 3 0 2 3 2 1 1 0 1 2 2 
192 504 460 452 452 480 172 188 176 184 180 180 196 176 196 212 188 192 176 200 196 188 0 3 2 0 2 1 1 0 3 1 1 1 1 1 3 0 1 1 3 2 2 3 2 2 3 3 0 3 2 3 1 1 2 1 3 3 2 2 1 3 0 1 2 0 3 2 1 0 0 3 3 2 1 1 1 1 2 3 0 2 0 1 2 3 
192 496 460 444 464 428 160 196 208 216 176 184 184 164 208 200 176 192 192 220 192 184 0 0 0 1 3 2 1 0 3 3 3 3 0 1 2 3 3 1 0 3 0 3 0 3 2 2 2 2 1 1 1 0 3 0 3 3 3 3 0 3 0 0 0 2 1 1 0 0 0 0 1 3 1 0 3 1 1 3 1 0 2 0 1 3 
192 500 440 452 456 456 188 196 192 204 220 200 184 188 184 204 192 184 200 160 192 200 2 2 2 2 1 0 2 0 3 0 2 3 1 1 3 0 1 0 2 3 2 1 1 1 2 3 2 1 1 1 3 0 2 3 2 1 3 1 3 1 1 1 0 3 1 2 3 0 2 0 2 2 0 3 3 0 3 3 0 0 1 0 3 1 
196 496 444 460 444 456 156 188 180 188 184 192 200 172 196 224 180 208 208 204 216 180 3 0 1 1 3 1 1 3 3 3 1 1 3 0 0 2 2 2 2 3 0 0 1 2 2 1 2 0 1 2 1 1 0 1 2 2 2 1 1 2 0 1 2 1 1 0 3 3 3 0 3 2 1 0 3 3 1 1 0 1 3 2 1 3 
192 492 456 476 436 456 136 176 208 176 192 180 180 188 176 200 200 192 228 216 220 192 3 2 1 0 2 1 2 3 3 2 1 2 1 3 0 2 0 0 2 2 0 2 3 1 3 0 2 0 2 1 3 0 0 0 3 2 2 3 3 3 3 0 1 3 1 2 2 2 3 3 0 3 1 1 2 2 3 3 1 3 0 2 3 3 
192 508 444 448 460 452 156 156 184 200 172 168 212 216 204 200 200 188 192 188 192 176 3 2 1 1 1 1 1 3 2 1 2 3 2 3 0 3 0 1 1 2 3 2 3 0 3 0 3 2 3 3 3 2 1 1 2 3 3 2 1 2 0 3 3 3 1 3 1 0 1 2 0 1 2 3 3 2 1 0 1 3 1 2 0 3 
200 500 444 460 440 436 136 184 196 200 196 180 196 220 164 220 172 168 208 228 184 192 2 1 3 3 3 2 1 0 2 2 3 2 0 2 0 1 1 0 1 2 3 0 0 3 1 0 2 0 3 1 1 3 1 3 0 3 0 3 3 3 3 1 1 1 2 2 2 3 2 2 1 2 2 2 0 2 1 0 2 2 0 1 3 0 
196 496 448 460 452 440 180 196 196 208 164 192 180 180 184 204 176 176 216 200 180 188 3 1 2 3 2 1 3 3 1 0 0 2 0 2 1 1 3 3 0 1 1 2 3 3 3 2 0 2 1 0 0 3 2 0 2 0 0 0 0 3 0 3 0 1 1 2 3 1 2 1 2 0 0 1 1 1 1 2 0 1 1 2 0 3 
196 504 456 428 460 460 172 180 180 196 196 180 200 196 176 200 172 196 232 172 196 192 0 0 0 3 0 2 3 1 0 3 0 1 0 0 2 0 0 0 2 1 0 2 0 2 2 1 3 1 3 3 3 3 1 1 1 1 2 2 0 1 2 0 2 1 0 0 0 0 0 1 1 1 3 3 1 1 2 0 1 3 1 3 3 3 
196 500 440 460 452 440 196 220 180 188 196 172 160 212 180 196 188 204 216 184 216 208 3 1 0 3 0 2 0 3 3 3 3 1 2 3 1 2 1 1 2 2 0 2 0 0 1 0 1 2 1 3 1 3 3 3 2 2 2 0 1 1 1 3 2 1 3 1 1 0 3 2 2 2 1 1 3 1 0 0 3 1 0 3 2 1 
192 520 448 444 436 432 152 196 176 212 192 184 168 180 184 224 180 192 228 196 204 188 3 0 1 0 2 0 0 1 3 0 2 0 0 2 3 2 1 1 2 1 3 1 1 3 2 1 1 2 1 1 3 3 1 2 0 3 3 0 1 1 0 2 2 1 2 1 2 2 3 2 1 3 1 1 3 3 2 3 0 3 2 3 3 1 
200 496 428 456 468 444 168 204 216 216 180 160 216 192 176 232 180 204 196 204 220 192 2 3 2 1 1 0 3 1 0 0 1 2 0 1 0 0 0 1 2 1 3 1 3 1 1 0 1 2 3 1 3 2 1 1 2 2 1 3 1 0 0 4 3 0 1 2 2 3 0 0 1 3 2 3 0 3 1 3 2 0 1 1 2 2 
196 492 456 452 456 456 192 184 172 212 204 192 200 192 172 188 184 200 212 164 212 184 1 3 2 0 2 3 1 0 0 1 1 3 2 3 2 0 2 3 0 2 0 3 1 1 2 2 2 2 1 1 3 3 1 1 2 3 4 1 0 3 2 2 1 3 3 2 3 2 2 3 3 2 2 3 1 1 1 1 2 1 1 1 0 3 
188 488 468 444 452 460 128 164 188 188 180 188 204 200 188 212 196 188 180 184 156 216 2 2 2 0 1 2 3 3 3 0 1 2 1 3 3 1 1 1 3 1 1 1 1 2 1 1 0 3 2 1 2 0 1 0 0 0 1 2 3 0 2 3 2 0 0 2 3 2 2 1 0 3 0 3 1 3 3 1 2 0 3 2 3 2 
196 496 472 444 444 436 156 176 196 200 168 176 208 188 176 216 196 172 224 172 204 188 1 3 0 2 3 2 2 0 1 2 3 2 2 1 0 0 3 3 0 3 1 2 3 1 3 2 1 2 2 1 2 3 1 2 2 2 0 0 3 1 0 1 2 0 1 3 3 2 3 3 2 1 0 0 3 0 1 1 3 1 2 2 3 3 
192 508 468 456 464 460 180 212 164 180 196 180 200 220 172 232 180 196 184 152 192 200 3 2 1 1 1 1 2 3 2 2 3 3 2 1 0 2 0 2 1 0 1 3 0 3 3 0 3 1 1 2 0 3 3 1 3 1 1 0 3 3 4 2 2 0 0 0 3 1 3 0 0 0 3 2 3 2 0 1 2 2 3 2 2 1 
196 508 448 452 468 444 188 176 176 208 200 184 216 212 208 192 184 184 180 188 200 172 2 0 3 2 3 3 2 0 1 1 2 1 1 0 0 1 3 2 0 1 2 2 2 3 1 3 0 2 1 0 1 1 1 3 1 3 3 3 3 3 0 2 1 1 1 2 0 1 2 0 2 3 0 1 1 0 0 1 1 1 0 3 1 1 
192 516 460 456 456 456 180 196 176 216 176 168 232 180 168 216 184 208 208 184 200 172 1 3 0 2 2 2 1 2 3 0 0 3 2 2 1 2 3 3 1 2 1 0 3 2 3 3 3 0 0 3 0 1 1 2 2 1 3 0 1 3 3 2 2 0 2 3 3 3 1 2 3 4 3 0 2 3 1 2 1 3 0 3 3 3 
192 488 440 476 456 436 196 200 224 208 172 200 208 216 200 200 164 196 204 216 216 184 3 1 3 1 3 2 1 1 3 0 1 1 3 2 2 3 0 3 0 2 2 1 1 3 0 3 2 2 1 1 2 0 2 3 2 3 2 1 1 0 0 2 3 2 0 1 0 1 3 0 3 3 3 1 2 2 2 1 2 3 1 2 0 1 
192 488 452 456 436 416 168 188 192 236 192 156 216 180 180 200 176 200 228 188 212 212 2 3 3 0 1 1 2 3 0 0 2 2 1 0 3 2 2 2 3 3 2 3 2 3 2 2 0 2 1 0 2 2 3 0 1 3 0 0 2 2 1 3 2 2 1 0 1 3 0 1 0 2 3 0 0 0 1 2 2 1 2 2 2 1 
196 508 468 452 452 436 176 184 196 176 172 172 224 200 200 196 176 160 196 192 188 216 1 2 3 3 2 2 3 2 2 1 2 3 3 1 1 2 3 3 2 1 3 1 2 3 3 2 2 3 2 3 1 3 1 1 2 1 3 3 1 2 0 3 2 2 0 3 0 2 3 2 0 2 1 0 0 0 0 0 0 2 1 2 3 3 
188 504 440 448 448 452 188 176 188 184 212 212 192 180 196 204 176 176 204 200 180 212 0 3 3 1 2 2 1 0 1 1 2 0 2 3 3 2 2 2 3 1 2 1 3 2 2 0 0 2 3 1 2 1 2 2 0 0 1 0 0 2 0 1 2 2 2 2 1 2 2 2 2 0 3 0 1 2 3 1 3 1 3 1 3 1 
192 508 456 448 448 452 156 200 204 160 196 192 208 192 196 196 172 204 208 188 180 204 1 3 1 1 0 1 2 3 1 0 0 2 2 1 2 1 2 1 3 3 2 1 0 3 1 3 0 0 2 2 2 0 1 0 1 3 3 0 3 3 1 2 2 3 2 1 1 1 2 1 1 0 3 2 1 0 1 1 2 1 3 3 0 3 
192 492 464 460 476 436 200 176 180 192 184 192 204 168 180 212 136 192 224 188 192 200 2 3 3 1 3 3 1 0 1 2 0 1 0 1 4 0 2 1 1 1 2 0 1 1 2 2 2 1 0 3 1 3 3 3 1 0 3 1 3 1 3 1 3 1 2 0 0 0 1 2 2 1 2 0 2 1 3 3 1 1 0 1 1 3 
196 500 436 448 444 440 180 176 156 220 184 188 200 196 200 176 184 200 216 216 196 196 1 1 1 2 2 1 3 2 3 3 0 3 1 0 3 2 2 1 1 3 0 2 3 2 2 2 2 2 2 3 2 2 1 2 2 2 1 2 3 0 1 2 3 0 3 0 0 1 2 3 1 0 1 0 1 1 3 0 0 2 3 3 0 3 
200 504 456 460 452 464 196 180 212 204 196 176 196 188 172 200 152 184 196 184 216 184 2 0 0 2 1 0 3 3 3 0 3 1 3 1 2 3 0 3 3 3 0 1 1 3 0 0 0 1 3 1 0 0 0 2 2 3 3 2 3 1 2 3 2 1 3 2 3 2 2 0 3 0 3 0 1 3 2 0 2 2 3 2 1 0 
196 508 440 464 444 456 176 188 196 192 180 176 196 188 152 208 204 216 204 192 200 224 2 1 1 1 0 3 1 1 1 1 3 0 1 3 0 1 1 2 2 3 1 3 1 3 1 2 3 3 1 0 3 1 3 1 2 3 1 1 0 3 2 2 0 0 3 0 2 3 1 1 3 3 0 2 0 2 3 1 1 3 2 1 2 2 
192 512 448 464 476 452 164 164 208 180 168 192 160 220 184 216 148 200 180 200 208 192 3 0 3 1 1 1 0 2 0 0 0 2 2 1 1 0 2 0 3 3 3 2 3 0 0 2 3 2 0 3 1 3 1 2 2 0 1 0 0 2 3 2 2 0 2 3 0 1 3 2 1 3 1 0 0 0 0 2 3 3 1 1 2 2 
192 488 472 460 448 456 172 192 192 188 188 176 216 188 164 200 180 204 184 180 176 164 3 0 3 0 2 3 0 2 0 0 0 0 0 3 1 3 0 0 3 3 2 0 1 1 0 0 3 3 0 2 0 3 0 0 1 3 3 0 2 1 0 0 0 2 1 3 1 1 2 1 2 1 1 2 1 1 2 2 3 2 0 1 1 3 
184 512 460 440 460 452 180 200 160 192 168 160 184 188 196 224 204 200 204 220 176 192 3 3 3 2 0 2 2 1 1 0 3 0 1 2 1 2 2 0 3 2 1 2 0 1 2 0 0 0 2 1 0 3 2 3 2 1 0 2 3 3 2 3 1 1 2 2 3 1 3 1 2 0 0 1 1 2 1 2 1 0 0 1 0 3 
192 492 456 448 448 436 212 204 192 212 204 192 180 208 160 216 180 196 212 196 212 188 2 1 2 0 0 3 0 1 1 0 2 2 2 1 3 0 2 3 3 3 2 1 0 1 4 2 3 1 2 2 3 2 3 2 2 3 2 3 1 2 2 2 0 0 2 0 1 1 1 2 2 2 2 1 1 1 2 2 3 3 2 2 1 0 
192 496 460 456 444 472 160 200 236 212 192 184 216 204 192 192 196 200 232 184 180 188 1 2 1 2 3 2 1 0 1 1 0 1 3 0 1 1 1 2 0 3 1 2 0 2 3 2 0 1 2 3 2 1 1 1 0 0 3 2 3 3 1 2 3 2 1 1 1 0 0 0 3 3 0 2 3 3 2 3 2 0 1 0 2 2 
192 504 444 464 456 452 184 180 196 180 172 152 188 180 200 192 188 188 220 184 184 188 3 3 3 3 3 3 0 3 2 0 1 0 0 2 3 1 1 3 3 2 3 1 3 1 2 2 0 3 2 1 1 3 0 0 3 0 2 1 3 2 3 1 0 1 2 1 0 0 2 3 1 1 1 2 2 0 0 0 1 3 2 1 2 1 
188 516 448 460 480 464 160 188 176 196 172 188 212 192 188 196 180 176 216 196 168 176 0 1 0 3 3 0 0 2 3 1 1 1 3 2 3 3 1 0 1 3 0 3 1 0 3 1 3 0 0 3 3 2 0 3 1 2 0 0 2 1 0 3 0 3 3 2 2 2 0 2 2 2 1 2 0 2 1 0 1 3 3 3 1 2 
192 492 452 464 444 444 152 184 188 228 168 176 208 180 172 196 172 192 224 224 200 184 2 0 2 0 0 3 1 1 2 2 1 0 0 1 2 2 0 2 1 1 3 1 1 0 2 1 3 2 1 3 3 2 2 1 3 2 1 0 3 2 3 1 2 3 3 1 1 3 1 1 3 3 2 2 3 2 1 2 0 2 0 0 1 0 
192 512 452 448 456 452 152 188 200 212 208 180 224 208 176 208 176 192 216 192 176 192 2 1 3 0 1 2 3 2 0 3 3 1 2 1 1 3 0 0 3 1 3 0 3 3 2 1 1 3 3 0 2 2 0 2 3 0 1 3 1 1 1 1 2 3 1 2 2 3 2 0 3 3 1 3 3 0 3 3 2 0 3 3 0 0 
192 524 440 436 452 432 160 232 188 208 212 188 224 220 192 220 144 188 200 192 180 196 2 3 2 2 0 0 3 1 2 2 1 2 1 3 3 1 3 1 0 3 1 0 0 3 2 0 2 2 2 2 0 0 1 2 3 1 0 2 1 1 1 0 2 0 1 2 2 0 1 3 1 2 2 3 1 0 3 2 1 0 0 0 1 1 
192 496 452 456 456 452 212 176 188 204 176 168 212 208 172 212 156 208 208 200 160 192 3 2 3 0 1 0 3 0 3 0 0 1 0 0 0 0 0 1 0 1 1 1 2 2 0 1 3 2 0 3 1 1 1 3 2 1 2 1 3 2 3 0 2 2 3 1 1 2 3 2 0 0 2 1 0 1 3 2 0 0 0 0 2 3 
196 508 472 464 456 444 172 200 208 236 156 212 192 192 196 192 192 184 192 196 200 188 2 3 2 0 0 1 1 2 2 1 2 0 1 3 3 2 2 3 2 2 1 0 2 2 1 1 1 1 0 1 1 3 0 1 1 2 1 1 2 1 3 2 2 3 2 0 3 1 0 2 3 2 2 2 3 1 2 3 3 0 0 3 1 3 
192 524 444 432 432 452 168 184 188 184 180 192 224 224 172 188 168 176 224 192 180 204 2 3 1 0 2 2 3 1 2 0 2 1 3 3 2 2 1 3 0 1 0 0 3 3 3 0 3 2 3 3 1 3 1 3 2 1 1 3 3 3 1 1 2 0 1 2 1 2 1 3 0 2 0 3 1 1 2 0 3 0 0 3 3 0 
184 504 460 456 452 452 172 176 180 212 168 196 200 200 188 192 156 204 204 208 196 204 2 1 2 1 1 1 2 3 0 2 2 1 3 2 2 0 1 1 1 3 3 0 3 3 1 0 0 0 1 0 2 0 2 0 0 0 1 3 3 1 3 0 3 2 0 2 0 2 1 3 1 2 2 3 2 2 1 1 2 0 1 2 3 1 
192 504 468 452 464 460 164 196 172 176 184 188 212 204 188 200 200 192 212 200 184 184 0 2 3 1 2 1 0 3 1 1 1 0 2 1 1 1 2 1 2 0 3 1 2 1 2 3 2 2 0 0 2 2 1 0 1 2 2 0 3 1 0 1 3 0 2 3 1 3 1 2 0 1 1 0 0 1 3 1 0 0 0 2 1 2 
192 496 452 460 456 464 168 204 176 200 168 192 184 188 172 220 212 216 196 184 244 220 0 1 3 0 0 1 3 3 0 3 1 0 2 2 2 3 3 2 1 2 2 2 1 1 3 0 1 1 2 3 2 3 1 3 1 1 3 1 2 1 0 3 3 1 3 3 2 3 3 1 0 2 3 2 3 1 2 2 3 1 0 1 2 0 
192 512 448 472 444 452 168 180 212 200 164 188 224 172 192 212 172 204 204 168 204 188 3 1 2 1 1 0 3 2 2 3 3 1 3 3 1 0 2 2 3 0 3 0 3 1 0 0 1 1 1 1 1 3 1 0 1 3 1 3 0 3 1 1 3 3 2 0 2 1 3 1 2 2 3 0 3 2 1 2 1 2 1 0 3 2 
192 516 460 456 468 444 184 188 208 192 204 172 212 224 188 212 196 192 216 216 216 184 1 3 0 2 2 2 2 2 2 1 2 1 0 2 3 2 2 2 2 3 0 2 2 2 1 0 1 1 2 2 0 3 1 1 2 3 2 2 0 2 2 0 2 1 3 2 2 1 0 0 2 1 2 2 2 1 1 2 1 3 1 2 2 2 
192 496 448 452 460 460 176 184 192 224 200 172 216 176 196 220 176 204 208 184 212 212 2 0 0 2 3 0 1 2 1 1 0 3 0 2 2 1 3 3 3 3 2 2 1 2 3 2 1 3 0 3 0 1 0 1 3 0 0 0 3 0 0 1 3 3 2 0 3 3 3 2 2 3 3 2 2 3 1 0 0 2 2 3 0 3 
188 504 432 464 456 448 176 200 180 228 208 192 224 192 192 188 184 204 188 188 224 208 1 1 3 1 3 1 0 3 0 2 1 0 2 1 1 0 1 2 0 1 3 2 3 0 3 1 2 2 2 1 3 0 1 1 3 3 0 1 1 2 1 1 1 1 1 2 2 1 2 3 1 1 1 3 0 0 3 1 1 1 3 3 2 1 
196 504 456 448 456 432 176 204 176 204 196 180 180 212 168 212 188 196 204 192 224 204 2 0 2 2 2 1 0 2 3 2 2 2 1 0 3 1 1 2 1 1 2 0 2 2 0 1 0 0 3 0 1 1 0 2 0 0 2 1 3 1 1 1 1 1 2 3 1 2 2 2 3 3 1 0 1 0 3 3 2 1 3 0 1 1 
192 500 448 456 472 448 172 204 176 232 168 180 228 184 184 196 156 172 212 224 180 204 3 3 3 3 2 3 0 2 1 1 1 2 1 2 0 1 0 1 1 3 2 1 1 3 3 2 3 3 1 1 1 0 0 3 1 0 0 1 1 2 1 2 3 1 2 0 2 1 1 1 3 1 3 1 2 1 3 0 3 1 3 1 1 0 
192 504 444 448 468 452 172 200 188 216 180 188 196 192 208 216 196 192 220 192 184 208 0 2 1 1 0 1 3 2 3 1 3 2 0 2 0 0 1 2 1 2 0 3 0 0 0 1 3 0 2 1 2 3 2 1 2 2 0 0 0 1 0 1 0 0 3 1 2 3 0 4 0 3 3 0 0 0 3 1 1 3 2 0 2 2 
184 500 464 448 456 440 168 200 152 228 168 212 224 188 164 228 172 212 216 200 232 196 2 2 1 0 3 1 0 0 2 2 2 2 0 1 3 3 0 2 3 1 0 1 0 2 3 0 1 0 1 1 3 2 2 3 3 0 0 3 3 3 0 2 2 3 0 3 1 1 0 2 3 3 3 3 1 2 1 1 2 3 2 2 1 3 
196 512 460 440 448 460 172 196 188 212 204 164 224 200 172 188 148 188 224 196 208 180 0 0 3 3 0 3 3 0 2 3 2 0 1 2 3 3 0 1 3 1 3 1 2 2 2 1 1 0 0 3 2 0 1 2 2 1 2 3 0 2 1 3 2 3 0 3 0 1 2 1 1 0 1 1 3 0 1 0 2 1 1 2 3 0 
196 504 452 464 460 448 172 188 188 192 208 192 208 192 184 184 212 200 204 176 176 208 1 1 2 3 1 2 1 3 2 0 0 3 1 2 3 2 0 3 2 2 3 2 0 3 3 2 0 2 3 2 2 2 3 3 0 1 0 1 2 0 1 2 2 3 3 0 3 0 1 2 1 2 3 3 2 0 1 1 0 2 0 2 0 3 
192 496 452 468 472 456 180 176 168 204 188 180 204 184 172 212 164 192 216 196 192 200 0 2 0 3 1 2 0 1 1 1 1 2 3 3 2 2 1 1 0 0 3 0 1 3 3 2 3 1 3 2 3 1 1 3 1 0 2 1 1 1 2 3 0 2 1 1 2 1 2 3 2 2 1 2 2 2 3 0 2 0 2 0 2 2 
196 512 460 464 460 440 172 156 212 196 192 180 176 180 220 224 172 192 204 192 244 200 1 2 3 1 1 3 2 2 0 0 2 1 2 3 3 3 1 2 0 2 3 2 0 2 2 3 3 1 2 1 2 1 1 2 1 3 1 2 2 2 2 2 1 3 3 3 3 0 0 0 1 3 2 1 3 0 3 2 2 3 3 2 2 1 
192 508 460 468 452 448 164 200 168 176 184 176 212 180 216 208 184 192 192 192 180 184 2 1 2 2 2 3 0 3 1 3 3 3 3 0 1 1 3 3 0 0 0 1 2 1 3 0 0 2 3 1 3 0 0 1 0 2 1 1 2 0 3 0 3 2 1 2 3 2 2 2 1 0 1 2 3 2 2 2 0 2 1 1 0 2 
192 492 440 448 452 424 184 204 216 212 208 192 200 184 180 168 184 204 172 176 204 204 2 2 0 2 3 0 2 3 0 1 0 0 3 2 3 1 2 1 2 1 1 3 1 1 3 2 1 1 0 1 3 3 3 3 3 1 3 0 2 1 3 2 0 3 0 0 1 1 1 2 2 0 2 2 1 3 2 1 0 3 2 1 0 1 
196 504 456 448 448 456 172 176 196 208 176 208 180 216 180 208 204 188 208 200 224 208 0 0 3 2 3 2 3 2 2 2 1 2 1 3 0 2 0 1 0 0 3 2 3 0 1 0 1 3 3 2 3 3 1 0 3 2 0 0 1 0 1 3 2 1 2 1 1 3 3 0 2 1 1 3 1 2 2 3 0 0 3 3 3 2 
192 524 452 440 436 456 188 188 196 196 188 184 180 196 180 224 188 172 220 184 192 188 0 2 0 3 2 0 1 1 2 1 1 0 1 2 0 0 0 0 2 3 0 1 2 0 1 2 2 2 3 2 2 0 3 2 0 3 2 2 2 2 3 1 0 2 2 3 0 2 1 3 2 2 2 0 0 1 0 1 1 2 1 0 3 0 
184 508 444 468 444 444 160 160 164 184 168 152 204 200 192 228 172 232 200 216 212 192 0 2 1 3 3 2 2 2 2 1 2 1 1 3 0 2 1 0 2 1 2 3 2 3 2 0 1 1 1 0 1 0 2 0 3 3 1 1 0 2 0 3 2 3 0 3 2 1 1 3 0 2 0 3 2 1 2 2 1 0 2 2 2 2 
