951 232 8 19 6 1 0 0 12 14 5 0 21 14 9 8 1 1 29 15 0 6 
964 178 20 12 8 0 0 2 5 11 2 1 6 1 7 3 1 0 15 16 6 1 
915 189 0 3 8 3 1 0 2 12 1 0 4 0 4 13 0 0 25 7 6 5 
946 187 1 18 0 10 0 0 10 13 1 0 3 9 7 11 0 5 21 5 1 1 
974 224 11 5 7 1 0 0 0 0 2 2 8 8 2 4 1 0 14 5 0 0 
890 206 15 17 11 2 3 1 12 7 0 1 5 14 0 9 1 3 14 23 13 7 
937 213 1 14 13 4 0 0 0 11 0 0 2 8 5 11 5 0 35 24 17 0 
888 221 11 17 3 4 1 0 5 2 2 4 9 18 14 0 1 0 32 28 29 6 
944 187 26 2 4 3 2 0 0 7 2 0 11 6 8 4 0 3 22 13 12 0 
917 198 1 3 17 0 0 1 0 17 2 0 2 14 13 9 0 6 30 12 10 0 
970 179 0 3 4 0 1 0 0 12 1 0 8 10 2 6 0 0 11 9 4 1 
922 212 4 3 20 0 0 3 19 4 8 0 0 0 8 4 10 2 17 22 3 0 
898 209 3 3 4 2 0 0 12 4 0 2 17 0 3 12 3 0 17 26 20 1 
948 158 6 2 3 0 3 7 0 14 0 0 14 0 2 3 2 1 13 23 13 5 
902 212 2 7 2 0 0 0 0 9 1 0 19 0 5 3 5 0 12 24 12 2 
895 205 1 4 3 1 0 0 0 12 0 0 19 6 3 9 0 1 14 23 5 15 
988 169 3 16 11 1 0 0 7 10 0 8 13 6 19 17 0 4 14 14 6 0 
938 190 12 8 6 1 3 0 6 7 2 0 4 12 4 9 0 0 32 19 3 1 
972 181 8 4 2 5 0 2 2 7 0 0 3 8 1 1 1 3 28 11 5 2 
983 180 16 6 21 3 4 3 20 5 5 0 6 7 7 12 0 1 20 4 3 9 
919 163 16 18 6 2 0 0 0 16 0 0 16 8 1 8 2 1 18 15 3 9 
948 202 23 6 1 4 1 2 7 13 0 0 3 9 7 11 0 4 17 11 12 2 
978 183 0 5 1 3 4 0 1 17 0 0 6 10 3 2 0 1 10 3 3 7 
951 195 5 17 2 3 4 0 12 19 3 2 14 3 8 4 0 0 12 11 4 1 
908 145 9 17 6 3 4 0 10 12 0 0 2 6 7 10 0 5 28 12 0 0 
928 170 8 6 16 12 4 0 16 2 0 0 2 9 12 3 0 0 13 7 0 3 
887 181 10 0 0 2 1 1 1 20 1 0 9 14 1 3 1 0 27 30 7 12 
937 186 4 4 10 0 2 2 1 11 1 0 15 9 11 5 0 1 18 2 12 0 
887 228 10 8 2 4 3 0 5 12 1 0 8 0 0 0 0 0 33 31 11 1 
925 162 16 5 0 1 2 2 3 7 6 3 0 0 0 7 4 1 27 27 6 0 
950 167 11 8 15 4 0 0 7 12 0 0 10 23 8 5 0 2 14 18 9 7 
940 201 4 4 5 0 0 0 9 3 1 3 4 16 0 2 0 1 11 15 1 10 
945 156 14 2 4 6 2 0 8 8 3 0 14 2 0 0 0 3 13 11 1 2 
935 207 9 5 11 2 1 3 5 10 0 0 8 15 0 19 0 2 21 34 19 4 
972 170 1 16 4 6 1 0 5 14 2 0 10 3 4 3 0 0 17 25 11 0 
911 208 1 9 1 4 3 5 0 15 0 0 7 6 3 9 0 3 23 19 0 15 
945 172 3 6 2 4 3 4 4 14 0 0 6 6 0 13 0 0 12 10 0 4 
940 166 4 8 1 1 0 0 14 20 0 0 15 12 4 8 0 0 10 12 1 3 
934 140 3 12 1 2 0 0 13 7 0 0 2 10 1 8 0 0 37 20 9 4 
953 216 14 3 18 2 1 11 5 6 0 0 1 1 9 9 0 2 12 11 1 0 
915 240 5 19 8 7 2 0 2 16 4 4 8 5 9 12 3 7 24 17 10 6 
918 191 1 4 6 3 0 2 6 6 4 0 13 6 2 1 4 1 21 11 6 0 
955 202 2 7 3 3 0 0 5 8 1 0 7 3 7 9 0 1 12 20 3 0 
938 167 11 5 7 1 0 6 4 7 2 1 11 10 3 11 0 2 4 8 7 3 
949 201 3 34 11 3 1 3 0 5 0 5 9 7 1 2 0 1 14 5 1 6 
951 128 2 7 19 2 0 0 4 10 0 0 7 11 3 4 9 3 10 4 11 1 
961 193 7 4 11 7 0 1 13 5 0 0 4 7 6 1 0 1 19 13 0 3 
957 246 10 4 0 0 0 0 5 8 5 0 7 8 0 0 0 0 13 18 10 14 
920 188 2 13 2 3 0 1 6 4 0 3 1 6 3 20 0 0 14 9 15 4 
979 172 0 7 1 1 0 1 1 11 0 2 5 7 2 1 3 0 14 10 1 0 
898 240 1 14 6 3 0 1 7 5 0 0 4 5 7 11 1 0 26 0 10 0 
927 156 5 25 3 3 0 1 0 7 9 1 22 8 1 1 0 0 19 25 3 4 
940 191 2 22 7 9 0 0 7 9 1 2 11 11 5 0 0 2 17 19 2 2 
925 173 4 9 1 4 3 2 0 5 5 2 16 11 2 3 0 0 27 19 3 0 
950 214 8 18 0 2 2 4 13 20 1 1 7 5 2 9 4 1 23 3 14 20 
964 165 6 10 31 0 0 0 10 22 5 0 10 3 8 17 0 1 9 7 0 5 
936 193 11 4 4 5 5 4 2 5 0 5 8 5 9 6 0 0 11 3 0 3 
951 196 11 25 2 4 0 2 0 17 0 0 17 3 0 8 1 0 8 12 7 0 
950 202 3 4 4 4 1 0 3 14 0 0 6 13 0 0 0 1 20 26 4 4 
937 158 0 6 18 4 1 0 0 10 0 0 6 1 0 3 2 1 16 11 7 7 
931 211 0 4 12 3 0 0 8 4 6 2 4 20 6 0 0 4 12 22 3 2 
918 210 10 8 7 0 0 1 0 10 0 0 15 0 6 7 0 0 21 37 0 0 
950 192 16 0 8 1 0 0 4 8 2 0 14 10 0 11 0 0 7 15 2 12 
932 185 21 9 7 2 9 2 7 9 1 0 8 11 0 5 0 0 25 18 13 0 
908 185 4 0 3 2 0 0 7 24 0 1 6 16 0 5 0 0 25 8 5 0 
943 206 2 0 2 4 0 1 15 13 0 0 12 1 7 12 0 4 19 17 0 2 
950 219 5 2 2 0 0 0 7 4 0 2 0 7 0 5 0 3 15 21 3 0 
940 186 8 1 3 2 1 1 7 13 0 2 4 0 6 3 0 0 14 17 1 3 
965 183 2 4 1 4 0 0 2 5 0 3 13 1 16 13 0 2 15 20 4 2 
971 183 3 19 4 0 0 0 4 0 0 1 3 0 10 4 1 0 18 9 3 0 
899 221 5 1 3 3 2 3 0 16 0 0 10 3 0 5 0 0 17 20 0 3 
925 193 6 6 10 1 1 2 7 10 0 0 9 3 10 5 3 5 9 16 0 2 
918 174 4 4 3 1 0 3 6 0 0 0 12 3 3 2 0 1 22 1 6 0 
964 173 8 5 10 4 0 0 7 12 2 6 0 3 5 0 0 9 16 9 8 4 
914 225 10 2 1 1 0 1 9 9 1 0 4 1 11 4 2 1 21 4 0 2 
941 150 1 4 4 0 0 0 2 7 1 0 0 7 22 6 0 4 29 12 0 3 
927 188 36 24 18 4 3 0 15 13 0 0 18 19 7 5 3 0 23 17 7 9 
937 216 2 18 10 3 5 0 0 6 11 5 16 4 6 14 0 0 16 24 3 11 
904 235 11 0 0 3 1 6 4 6 5 3 5 5 3 6 1 0 14 21 5 1 
904 180 12 3 4 1 1 3 6 10 1 1 0 15 8 9 1 1 29 15 3 0 
