544 11 5 3 18 20 18 9 11 28 51 29 23 37 50 55 51 
452 18 19 14 1 28 14 19 20 33 31 38 57 55 44 57 48 
420 13 5 21 17 37 11 36 30 23 44 43 30 69 63 49 40 
464 10 10 18 10 17 34 27 39 23 47 42 60 44 38 46 51 
472 3 0 15 7 32 35 30 30 30 43 36 27 51 52 64 54 
408 23 29 22 26 24 20 46 14 31 39 45 45 36 56 61 54 
484 0 20 21 13 14 23 11 8 26 29 45 32 52 43 50 48 
488 17 14 21 9 30 26 35 25 33 27 32 34 48 45 44 56 
492 13 14 23 9 25 15 4 3 41 30 45 36 46 46 48 46 
424 29 33 19 27 28 36 30 38 31 34 41 32 38 58 50 50 
448 11 19 18 38 36 39 34 20 41 23 37 21 38 43 53 47 
532 9 2 0 3 19 19 25 14 23 46 30 28 34 47 41 46 
460 20 10 14 23 39 35 19 22 46 31 46 31 49 48 47 47 
468 9 6 13 36 25 35 33 22 31 48 50 36 54 54 51 47 
432 21 18 17 6 28 50 33 26 36 49 37 32 53 50 54 61 
492 10 2 17 1 13 39 23 15 29 43 50 25 36 46 60 52 
484 24 21 19 24 18 38 20 17 32 40 43 46 46 45 52 60 
476 8 11 9 24 29 24 31 24 33 53 39 29 21 52 50 59 
456 13 7 14 8 23 32 26 41 26 32 31 28 30 61 57 30 
516 6 22 15 6 19 14 24 18 32 29 45 33 31 51 54 55 
432 2 32 18 6 35 42 21 34 38 50 38 44 43 46 48 44 
492 18 13 9 8 18 23 20 16 36 24 38 27 48 49 53 39 
528 16 10 13 14 23 30 16 22 28 36 39 28 37 41 49 32 
444 20 28 22 14 26 29 37 16 40 43 47 38 50 42 55 54 
480 13 12 9 11 34 27 15 25 27 35 51 44 37 36 66 42 
424 15 21 21 30 29 37 34 15 38 43 42 50 59 38 55 56 
484 16 15 8 18 25 25 27 26 40 32 51 53 37 51 63 55 
460 22 13 22 6 32 44 22 14 41 42 45 27 56 53 55 39 
456 14 26 20 0 39 34 32 38 38 41 52 34 49 41 49 33 
428 18 35 24 16 21 47 27 34 42 48 45 24 42 37 46 49 
416 14 1 18 27 30 39 33 32 45 48 50 17 39 52 65 58 
460 6 20 24 6 24 44 26 31 43 37 25 30 46 36 58 58 
608 7 3 8 8 11 19 18 12 29 38 44 31 51 41 46 38 
580 2 13 10 7 13 24 15 9 33 44 29 17 46 43 45 40 
504 19 20 7 16 36 23 16 19 20 40 40 30 54 41 58 64 
492 3 4 15 9 23 26 12 13 31 39 37 42 50 46 65 51 
436 26 18 10 22 29 37 37 13 38 39 36 30 30 51 52 62 
460 25 22 12 11 12 21 20 37 39 35 40 24 36 44 59 46 
408 9 29 20 32 33 33 33 10 50 46 34 49 38 56 50 44 
484 19 23 19 16 34 34 14 20 32 35 36 32 45 40 39 43 
