0 95 86 83 94 77 95 87 90 85 82 96 92 84 98 88 94 
0 83 94 86 83 88 85 85 95 88 97 87 89 98 92 93 81 
0 92 95 94 85 90 94 89 92 87 96 94 85 87 95 81 87 
0 87 90 97 93 79 90 94 86 90 89 92 85 92 104 97 96 
0 84 93 93 88 81 93 95 113 98 89 91 84 86 84 93 75 
0 85 97 74 95 90 87 91 86 95 95 93 88 87 86 101 99 
0 95 86 87 88 99 85 92 92 96 86 87 90 84 90 86 85 
0 91 96 86 94 96 80 90 95 93 88 93 99 96 88 100 92 
0 95 79 89 99 92 92 92 103 88 91 92 88 91 97 92 91 
0 90 99 89 94 99 90 81 97 86 89 88 99 93 94 84 95 
0 90 94 88 94 86 86 84 97 88 87 98 89 91 91 88 86 
0 94 96 91 96 95 92 94 92 93 79 92 87 92 85 100 89 
0 82 85 84 77 81 92 98 93 89 85 97 80 101 96 84 89 
0 89 92 94 94 96 90 100 103 86 95 93 91 83 86 90 90 
0 86 92 93 97 88 87 88 89 88 93 103 87 91 85 88 95 
0 89 92 79 93 89 99 94 89 94 104 86 80 79 89 89 90 
0 88 89 96 87 83 95 94 83 91 101 98 90 90 90 99 89 
0 93 92 93 81 88 84 90 78 93 89 100 84 86 90 88 97 
0 67 100 94 95 86 93 95 75 96 85 99 86 91 85 97 90 
0 81 90 97 92 93 99 91 86 90 95 89 86 93 80 85 87 
0 85 87 85 90 93 86 88 90 91 87 85 93 79 81 91 98 
0 99 96 86 93 85 94 90 95 88 98 96 88 90 89 93 102 
0 86 86 92 91 91 97 83 99 87 87 88 94 97 94 86 89 
0 95 100 92 82 91 105 97 92 95 94 95 89 96 95 82 95 
0 83 89 87 99 93 82 90 94 90 90 88 92 88 98 93 98 
0 100 94 93 85 81 91 94 83 98 97 81 90 81 89 92 89 
0 91 91 96 87 85 94 81 91 88 88 89 86 93 94 96 92 
0 89 109 90 95 90 99 98 85 99 92 81 88 84 92 84 85 
0 83 80 94 88 92 82 84 102 92 89 92 91 93 92 97 86 
0 80 77 84 96 80 87 87 92 90 96 89 84 100 86 89 99 
0 84 95 87 85 81 99 98 94 84 93 97 93 84 99 84 84 
0 97 84 90 89 82 88 92 91 91 88 87 92 94 94 96 96 
0 89 88 90 76 78 90 85 84 75 83 94 95 98 81 89 99 
0 88 100 93 96 92 89 90 94 92 90 95 88 91 96 89 91 
0 94 97 104 86 99 89 92 88 88 87 89 95 88 87 95 94 
0 89 89 81 89 99 84 76 95 76 94 86 94 97 94 89 90 
0 81 91 78 94 90 73 82 87 97 92 89 87 101 94 87 83 
0 86 90 81 98 92 86 93 83 88 95 89 85 97 97 89 87 
0 90 82 77 86 94 94 96 76 86 87 93 88 77 96 84 91 
0 91 85 100 97 77 87 92 95 88 78 86 86 90 82 84 91 
