1272 3 0 2 3 3 3 1 2 0 2 1 2 0 0 2 1 
1316 3 3 3 2 0 3 3 3 2 2 2 0 3 3 1 0 
1364 0 1 2 2 1 1 1 2 2 7 1 2 2 1 3 0 
1380 0 3 0 0 0 0 3 0 3 5 0 0 1 2 1 0 
1316 0 0 2 0 1 2 3 3 3 2 0 0 1 1 1 2 
1312 2 2 3 1 3 1 2 3 0 1 4 3 1 2 2 3 
1308 0 1 2 1 1 1 0 3 3 3 3 2 3 1 3 0 
1304 1 2 3 3 2 2 6 0 0 1 2 0 2 0 0 3 
1312 1 3 2 0 3 2 1 1 1 2 2 3 2 2 1 1 
1332 3 0 3 2 3 3 1 3 0 0 3 3 3 2 2 2 
1272 0 3 3 0 2 3 2 1 3 4 2 0 0 2 2 3 
1364 2 0 0 0 2 2 0 1 3 2 2 0 1 0 0 0 
1324 3 0 2 2 2 1 4 3 0 2 0 1 1 1 1 2 
1288 2 1 3 0 1 3 5 2 3 2 0 0 0 1 0 2 
1276 0 0 3 0 1 3 0 2 0 3 1 2 3 0 1 2 
1264 0 0 2 1 1 3 1 1 3 2 3 3 2 3 0 3 
1348 0 2 1 0 3 2 0 2 0 4 2 2 0 2 0 1 
1332 0 3 3 3 1 3 1 3 1 0 0 2 1 0 0 1 
1352 0 0 0 1 0 3 3 2 0 3 2 2 3 0 0 1 
1340 3 3 1 1 0 3 1 3 1 0 0 0 1 0 1 1 
1324 0 0 2 1 0 1 0 2 0 3 1 2 0 2 2 3 
1280 2 0 3 1 2 5 3 2 0 3 3 1 0 3 0 0 
1268 2 2 3 2 0 3 4 3 2 3 3 2 0 3 1 3 
1336 3 1 3 0 3 3 2 2 3 1 2 2 2 2 2 2 
1276 1 0 3 1 3 3 5 3 0 1 4 0 3 3 2 3 
1304 0 2 2 3 2 1 3 2 0 3 1 1 0 3 2 3 
1316 3 1 3 0 1 3 2 1 0 0 5 3 1 3 2 2 
1324 1 3 3 2 1 1 2 0 2 2 4 1 1 1 3 0 
1308 2 0 1 0 1 3 2 0 0 3 4 3 2 0 3 2 
1356 3 3 3 3 2 2 5 1 1 2 1 1 2 2 3 1 
1304 1 3 2 0 0 3 1 3 1 0 3 1 0 0 0 2 
1312 0 3 0 0 3 3 3 0 3 4 3 1 1 3 0 3 
1344 0 0 0 3 1 3 2 1 1 5 3 1 2 0 0 3 
1304 0 0 2 3 1 3 0 3 2 2 2 3 1 2 3 2 
1316 1 3 0 0 2 2 1 0 2 1 2 1 2 2 1 1 
1288 1 2 1 1 1 0 0 0 0 6 0 3 1 2 3 3 
1300 3 1 3 1 2 3 1 0 2 1 0 2 0 3 1 3 
1420 3 1 3 0 3 0 1 0 2 1 1 0 3 3 2 0 
1372 2 2 1 0 1 1 3 1 2 1 3 2 3 3 3 2 
1272 0 2 2 2 2 1 1 1 1 2 4 1 3 2 1 3 
