0 88 99 90 89 103 95 115 89 103 89 93 96 98 103 104 96 
0 90 96 94 101 98 103 95 90 113 99 93 87 103 98 106 98 
0 85 95 97 105 80 101 91 102 94 107 112 100 82 106 99 123 
0 92 101 99 94 112 103 92 100 108 101 98 104 95 107 102 103 
0 85 96 84 89 93 114 104 98 109 114 113 95 97 97 103 92 
0 96 109 101 106 96 116 103 97 86 104 96 100 99 89 100 99 
0 88 96 92 104 84 93 101 93 97 86 97 96 97 99 108 103 
0 90 95 104 106 84 97 101 100 82 109 89 98 88 89 101 82 
0 98 92 92 96 99 106 99 105 88 108 107 93 91 94 87 106 
0 80 103 90 109 83 107 99 103 90 115 106 98 95 104 100 103 
0 90 99 105 101 82 97 101 86 97 92 107 104 90 115 111 102 
0 99 93 84 99 91 104 111 99 100 97 120 104 96 92 96 116 
0 104 98 102 95 89 97 99 101 75 100 96 98 84 108 99 97 
0 92 88 92 94 97 92 107 102 103 103 106 99 97 98 89 107 
0 81 83 100 91 96 86 104 101 113 108 108 99 98 93 106 94 
0 92 82 91 109 91 102 111 96 104 96 110 105 94 100 103 97 
0 93 103 94 94 98 101 93 102 101 100 96 97 99 108 102 104 
0 91 93 101 95 113 102 97 97 107 89 106 96 105 92 98 98 
0 97 97 94 95 99 106 98 97 92 104 102 103 103 109 112 97 
0 96 99 103 93 94 84 109 113 96 111 109 99 98 96 89 103 
0 93 91 110 91 89 91 101 101 98 101 109 109 90 91 105 94 
0 100 107 97 99 88 104 104 99 98 116 117 108 98 96 102 113 
0 101 101 95 91 101 103 100 104 104 101 99 92 85 113 100 94 
0 86 94 85 93 89 99 99 92 92 100 104 98 96 100 101 106 
0 99 91 95 80 111 94 101 82 96 99 100 105 91 101 110 98 
0 95 97 82 94 95 97 115 99 94 96 109 100 84 81 89 94 
0 96 94 88 91 99 95 115 99 94 110 104 115 103 103 117 101 
0 99 93 89 96 103 108 88 101 90 99 93 108 107 93 102 118 
0 88 82 94 92 92 106 111 100 86 107 105 106 95 97 95 98 
0 88 85 87 98 102 108 94 108 89 99 104 93 86 106 107 99 
0 91 106 95 109 90 105 101 104 90 101 98 100 91 103 116 102 
0 91 101 101 106 86 89 96 97 89 109 102 101 102 104 99 117 
0 103 97 89 106 94 108 101 100 97 107 94 105 105 105 92 103 
0 97 96 90 105 95 103 102 92 101 104 100 102 96 97 81 97 
0 88 92 113 89 87 104 104 111 95 93 113 100 89 103 102 100 
0 86 93 93 87 90 100 93 95 111 109 104 96 90 86 96 106 
0 110 92 99 101 98 93 103 97 92 107 98 98 89 106 101 108 
0 91 100 90 76 99 105 106 99 99 114 96 95 88 105 102 101 
0 86 88 97 102 98 93 104 98 82 102 111 99 98 92 93 106 
0 75 105 98 86 98 102 102 89 99 105 97 96 96 88 100 96 
0 102 105 104 108 101 105 106 101 99 89 98 98 100 107 92 96 
0 81 89 90 87 89 100 106 86 101 99 99 98 101 81 99 94 
0 98 98 92 95 99 108 115 96 101 103 108 97 97 97 84 102 
0 92 93 99 84 104 111 109 100 91 109 106 103 87 96 90 93 
0 80 91 93 101 95 94 103 99 92 102 94 113 99 99 116 111 
0 99 94 96 89 99 106 106 103 92 100 90 85 108 104 93 95 
0 92 89 104 81 96 97 96 97 92 101 99 104 90 109 99 91 
0 95 86 95 85 100 103 95 96 103 102 98 92 106 105 105 98 
0 98 109 85 99 91 107 98 97 97 96 111 100 102 103 92 102 
0 96 100 98 90 99 107 100 93 90 96 101 95 99 87 98 94 
0 108 85 97 91 104 104 99 106 102 91 105 93 97 87 95 102 
0 94 96 100 100 101 109 97 105 97 97 102 106 99 100 99 112 
0 91 108 101 89 94 111 85 99 84 89 105 94 95 94 105 102 
0 98 105 87 102 97 99 98 91 105 105 100 94 102 102 105 94 
0 88 101 103 102 87 97 103 91 88 103 102 97 92 90 109 92 
0 96 107 105 92 108 114 100 101 98 104 98 102 92 97 97 105 
0 88 104 103 92 105 103 105 108 94 99 106 80 82 91 86 84 
0 100 99 88 99 91 103 103 100 96 96 112 102 87 119 102 106 
0 96 103 85 88 99 107 101 96 100 89 104 96 93 96 107 106 
0 110 94 103 98 92 99 110 96 96 102 108 100 91 100 103 97 
