0 94 92 96 102 100 93 97 100 97 100 92 95 100 94 88 104 
0 91 94 101 104 107 78 109 110 113 104 99 100 92 97 98 110 
0 88 107 105 115 89 109 104 113 97 94 90 101 102 114 103 96 
0 80 87 112 100 94 97 100 108 105 115 107 110 104 96 105 100 
0 94 92 95 98 97 86 108 102 114 107 103 89 96 105 89 105 
0 99 97 92 106 91 90 93 105 106 116 107 99 99 108 101 114 
0 92 97 99 104 101 105 103 111 105 94 90 94 104 102 109 104 
0 110 101 92 110 109 111 104 101 96 105 96 96 106 95 100 95 
0 96 96 99 97 108 96 88 107 107 96 82 100 100 109 91 103 
0 99 113 102 115 93 94 95 85 106 113 92 89 112 96 94 84 
0 82 103 85 103 96 103 95 105 90 100 94 93 101 106 110 116 
0 100 87 101 110 96 94 98 99 90 99 81 93 103 98 90 84 
0 89 101 98 95 99 77 96 95 103 98 100 101 96 101 102 91 
0 71 81 82 110 86 95 95 89 88 106 94 105 118 97 105 90 
0 80 85 95 102 86 79 107 89 101 104 90 110 102 109 99 101 
0 88 99 108 105 101 105 94 100 86 102 108 110 90 106 107 93 
0 97 98 96 102 98 99 98 105 101 90 117 102 103 98 110 94 
0 83 93 100 106 85 101 100 105 105 92 86 98 98 97 93 91 
0 92 93 84 101 109 98 92 92 94 95 89 95 98 89 103 100 
0 81 100 97 95 90 89 97 95 95 99 93 100 86 107 104 93 
0 84 104 98 108 88 101 91 102 97 105 98 108 95 100 97 97 
0 106 97 106 95 101 87 98 94 90 97 91 102 103 97 101 99 
0 91 90 102 111 114 100 112 106 107 101 100 91 96 90 99 97 
0 87 96 93 98 103 108 114 94 98 101 102 104 97 94 103 111 
0 81 89 92 100 88 82 117 101 103 105 83 93 93 105 94 108 
0 83 87 100 104 104 106 102 101 98 106 98 108 99 91 103 100 
0 101 87 98 104 88 82 93 107 92 103 85 93 98 107 102 101 
0 95 102 111 101 90 99 113 106 83 99 85 100 103 116 95 97 
0 95 100 93 115 98 112 103 97 83 101 105 101 94 100 99 101 
0 98 95 105 96 99 93 106 97 95 95 95 87 104 105 94 92 
0 92 99 99 91 94 104 106 96 92 92 93 108 100 100 94 98 
0 89 104 88 90 105 104 90 100 103 97 86 92 108 100 96 104 
0 85 84 99 107 110 104 98 94 100 93 97 104 104 97 102 86 
0 92 105 103 108 93 84 105 108 98 85 97 89 110 112 98 105 
0 94 93 99 98 97 87 99 108 107 98 105 104 93 97 97 98 
0 88 87 94 114 86 95 95 106 95 91 93 92 98 105 94 87 
0 94 97 90 100 96 96 89 109 94 105 102 104 96 101 105 99 
0 104 95 93 102 89 107 101 104 102 97 101 113 101 96 111 99 
0 88 92 90 95 105 92 103 103 99 97 95 108 96 101 104 91 
0 89 88 96 91 85 104 100 110 102 92 104 113 99 105 95 102 
