1456 55 64 53 43 45 49 53 57 61 79 74 61 54 48 55 74 58 85 75 76 69 73 66 69 79 79 76 78 65 97 89 66 61 77 90 75 72 63 81 54 96 81 94 88 87 68 44 36 72 66 83 94 79 79 80 18 71 88 95 85 94 92 78 50 
1548 58 63 77 70 39 42 39 26 67 70 65 53 69 43 38 80 68 78 60 52 89 77 74 71 77 57 75 95 98 86 65 56 76 67 85 91 75 93 50 55 78 69 88 96 105 91 74 45 82 64 72 90 83 64 76 36 61 85 96 80 84 89 85 28 
1448 61 66 75 52 89 53 63 44 62 73 70 73 64 54 89 82 65 69 74 61 65 86 88 74 70 70 66 83 67 90 68 80 75 88 94 96 82 69 60 71 86 77 84 92 103 88 62 53 79 83 93 95 83 66 86 37 91 93 100 84 86 86 72 10 
1508 59 68 54 71 59 57 44 42 63 59 79 76 74 38 34 72 69 96 69 67 62 73 68 68 61 73 78 65 74 70 80 52 77 64 94 82 80 71 61 52 74 60 96 83 86 106 71 41 72 84 80 82 77 74 96 24 71 93 86 89 80 88 67 52 
1468 68 64 62 83 59 69 60 32 80 69 75 53 51 55 46 58 84 57 57 72 89 61 70 63 79 64 93 85 105 77 68 68 71 92 87 83 58 58 82 74 70 76 87 85 87 80 88 61 85 84 85 103 88 91 46 74 87 92 85 102 92 87 75 14 
1480 76 43 56 64 47 33 49 35 75 60 70 55 51 66 46 69 86 71 80 65 79 92 59 79 73 78 66 108 102 57 79 59 61 82 97 76 88 86 50 71 73 72 85 84 68 91 79 41 73 58 86 77 92 94 68 88 61 77 79 78 90 98 75 60 
1468 72 65 78 66 49 39 27 52 72 60 68 55 51 40 52 62 63 84 74 82 77 92 78 63 57 80 72 85 79 64 80 59 66 88 95 78 82 98 73 74 71 86 87 82 95 67 71 53 79 76 92 85 74 69 81 61 89 92 90 90 72 94 73 36 
1456 40 54 71 70 48 52 61 47 77 63 67 50 68 69 56 76 72 68 75 42 61 94 72 49 75 71 82 66 78 79 72 75 66 85 92 87 78 68 63 70 99 96 86 93 95 71 60 34 74 72 83 90 91 84 72 50 81 100 72 79 81 101 80 31 
1444 52 74 64 69 53 50 60 46 71 69 64 54 52 42 40 70 60 87 82 50 95 85 95 92 65 82 73 92 91 88 80 69 56 68 84 96 86 88 62 78 67 86 81 102 102 68 62 50 76 83 90 91 95 67 64 57 60 84 89 107 86 92 68 7 
1444 54 59 60 61 57 56 44 41 52 82 67 82 54 56 67 82 90 78 87 49 92 64 77 68 73 58 77 99 76 68 45 52 76 68 89 82 94 73 47 46 74 96 91 96 63 80 68 59 80 73 88 86 78 74 74 53 79 85 88 102 102 73 76 33 
1576 64 92 68 79 55 51 39 31 62 68 70 41 51 39 51 54 65 59 71 51 70 67 76 46 77 56 51 88 76 80 62 61 69 81 87 80 84 76 64 49 78 78 96 92 82 66 76 38 92 69 78 76 87 79 50 26 87 90 90 72 95 86 76 21 
1440 84 63 58 57 57 28 52 38 71 79 65 50 57 52 39 64 63 67 77 58 84 71 81 69 62 73 80 90 95 88 72 62 80 64 83 90 96 59 63 54 86 86 93 103 105 88 64 85 82 81 83 97 80 82 48 37 81 86 92 102 87 101 82 63 
1556 65 66 54 72 54 35 37 54 51 72 67 74 54 41 50 81 57 71 68 64 73 79 75 68 56 73 80 82 65 76 58 59 65 77 86 74 68 73 69 90 62 64 78 82 85 91 86 60 92 77 76 75 85 102 89 40 87 76 78 70 96 88 81 30 
1524 52 76 78 52 73 33 32 43 66 74 70 66 62 46 59 59 66 35 57 75 86 95 71 65 81 69 54 87 79 91 66 62 68 80 93 61 86 75 77 66 70 74 100 85 88 57 107 40 85 81 79 86 91 82 76 27 70 83 94 78 91 77 79 33 
1388 64 67 75 50 67 71 46 38 63 79 75 65 63 53 36 71 81 63 74 63 76 72 74 66 77 86 81 84 95 91 69 67 90 76 97 77 92 75 75 75 88 73 78 80 71 85 69 83 71 81 86 102 90 84 75 49 67 72 118 103 83 94 84 24 
1576 63 62 69 71 58 40 63 48 52 70 67 78 61 51 45 73 53 62 69 68 71 88 58 60 84 68 72 81 70 61 58 53 55 78 91 114 91 77 70 51 69 74 87 73 87 68 58 40 79 72 89 85 78 75 85 22 81 85 72 81 95 61 88 46 
1480 54 41 60 56 48 66 32 50 68 69 63 84 47 46 38 78 62 72 54 66 81 86 50 98 66 76 77 81 81 98 67 60 81 94 97 83 69 73 100 77 62 57 85 85 90 92 78 65 67 81 92 97 84 91 85 45 77 78 83 95 82 93 83 9 
1536 62 58 68 60 39 38 45 37 70 64 69 62 52 33 49 79 81 66 85 59 83 68 55 50 55 72 67 93 95 81 61 52 82 68 101 69 73 73 81 45 86 71 81 85 80 84 56 67 80 74 89 85 96 81 73 50 89 90 92 81 94 96 77 24 
1540 60 69 70 63 40 63 52 57 63 96 57 53 75 36 36 67 60 93 56 71 71 64 58 62 77 93 69 69 88 60 80 63 67 55 91 93 67 78 69 48 74 60 90 80 92 68 69 36 64 89 80 97 86 68 67 73 81 90 101 84 82 96 82 15 
1544 45 63 64 56 60 48 55 64 62 60 67 72 67 59 56 81 72 73 59 70 77 80 88 73 95 71 59 65 70 76 78 72 80 70 72 102 70 100 76 65 89 91 80 92 96 65 65 52 87 86 83 74 89 90 77 34 75 71 96 97 87 82 64 5 
1496 50 52 50 68 72 32 57 38 83 74 76 78 41 58 61 72 72 57 46 58 64 76 82 60 57 67 68 80 92 68 60 89 70 85 96 89 78 81 88 45 89 84 87 93 89 87 57 42 80 67 94 77 81 76 87 43 86 76 99 112 83 93 87 13 
1504 71 69 49 69 49 68 34 31 73 70 80 61 53 56 43 55 72 64 67 39 69 59 59 58 72 73 47 83 89 87 75 65 77 67 84 82 76 57 79 57 72 84 73 72 84 78 82 56 70 86 83 95 76 88 69 68 83 80 97 89 81 92 66 59 
1516 63 58 55 45 67 69 58 57 60 77 69 62 81 49 34 79 73 59 72 65 78 68 70 58 77 75 79 88 77 68 69 74 74 74 68 84 89 89 79 60 69 86 78 89 97 76 74 41 74 80 92 93 81 83 83 38 74 89 94 78 97 85 80 10 
1504 47 75 61 66 46 50 32 35 59 70 63 57 71 66 51 64 59 58 74 77 95 76 89 61 47 67 71 83 87 73 78 58 70 82 90 90 78 91 85 45 78 87 91 84 87 71 51 34 74 71 86 89 72 70 55 62 70 93 76 93 95 88 84 23 
1412 48 56 84 80 57 48 43 38 55 81 47 72 79 35 47 85 61 64 86 77 63 79 84 69 63 83 44 90 78 73 69 60 63 90 61 92 78 78 75 51 79 79 70 80 70 92 73 68 69 78 87 95 98 88 91 59 85 75 98 89 77 93 79 30 
1448 55 75 70 66 68 45 36 26 75 80 56 69 45 45 55 63 63 83 70 63 73 92 79 48 72 85 77 85 79 74 63 65 70 83 79 81 102 69 70 40 87 91 92 95 86 74 55 58 64 82 93 98 102 69 75 41 70 75 89 91 79 79 81 25 
1412 83 73 60 69 63 75 55 46 88 60 64 57 61 67 62 90 66 63 77 62 77 96 78 65 83 73 62 90 89 76 56 57 76 67 84 94 92 82 53 65 62 81 86 100 79 79 67 52 72 76 97 95 86 76 83 60 73 87 89 82 88 76 87 24 
1528 64 63 59 63 55 50 73 30 57 84 84 52 60 41 52 63 62 65 54 72 72 75 72 68 60 92 62 95 87 73 50 74 48 90 80 81 100 93 72 57 86 78 91 82 70 84 62 82 60 97 81 85 81 85 84 26 69 87 105 94 87 79 85 35 
1500 66 46 49 56 50 44 48 31 43 75 72 68 49 43 39 66 65 73 76 78 87 98 84 58 75 80 66 86 86 68 61 72 78 74 85 75 82 77 78 67 78 72 71 94 73 85 89 77 81 67 74 80 80 100 58 60 76 84 81 91 79 83 66 49 
1560 55 51 49 55 55 43 34 59 61 78 67 53 45 59 66 67 62 70 67 54 95 90 74 54 72 66 55 78 74 63 81 93 71 85 76 88 60 61 62 72 79 71 81 88 77 79 79 58 79 77 88 79 86 85 80 32 84 83 85 90 91 88 78 9 
1472 67 57 51 68 83 51 43 50 72 51 79 74 34 51 50 51 61 64 56 68 83 67 65 69 52 80 62 84 78 80 63 70 71 72 89 89 81 86 67 70 62 72 89 77 90 65 58 37 83 58 73 85 95 88 51 46 79 84 89 93 105 93 87 48 
1464 66 67 58 46 62 50 42 40 59 72 68 77 75 77 49 70 62 78 56 65 83 82 80 81 75 58 60 88 93 97 91 70 62 69 97 91 71 76 58 49 66 70 78 104 79 71 65 39 81 67 75 93 77 67 72 73 83 91 78 103 79 79 86 41 
1436 54 82 73 86 70 63 40 52 65 73 64 88 56 56 38 83 61 78 74 69 81 68 101 77 64 86 66 86 86 77 78 60 89 92 78 92 67 97 62 31 80 64 74 69 80 85 47 70 73 84 76 94 94 65 64 52 75 86 92 91 91 82 78 56 
1508 92 64 64 60 72 60 46 30 47 84 71 70 68 43 43 88 64 73 90 71 84 88 60 70 66 76 78 85 70 73 79 53 74 76 89 99 75 77 78 57 80 98 82 83 95 58 55 45 85 68 80 96 82 67 69 36 76 93 89 85 82 94 72 41 
1500 57 64 66 65 62 40 50 44 47 66 73 61 49 63 26 71 59 47 67 54 78 82 76 76 67 56 62 82 67 75 86 58 59 67 79 71 85 85 75 57 64 63 92 91 82 86 84 38 76 91 86 89 92 73 65 85 77 91 86 67 93 96 87 22 
1528 78 72 90 68 64 56 44 45 78 70 71 53 90 51 46 77 82 77 66 70 89 77 68 81 44 64 43 100 74 81 64 79 73 83 78 88 80 69 66 46 93 76 88 86 73 69 50 59 77 74 78 76 67 70 48 31 89 96 94 87 73 86 79 36 
1568 47 45 50 48 49 77 39 21 67 66 66 75 60 39 36 94 61 61 86 64 65 75 56 49 83 69 73 85 97 79 62 74 86 82 79 76 77 78 68 60 89 67 94 80 75 85 71 47 64 82 76 103 91 90 67 40 68 86 104 92 81 82 71 40 
1444 50 57 57 72 59 61 47 35 72 78 73 71 64 41 69 70 57 73 66 54 84 90 75 78 74 92 57 92 91 90 92 70 75 69 86 73 108 74 72 57 79 88 94 96 74 64 80 64 69 70 85 82 91 65 56 43 90 80 101 72 72 88 92 60 
1508 49 49 72 67 41 46 60 42 74 66 78 76 50 53 43 74 46 63 65 68 89 70 94 63 75 89 66 81 75 70 62 85 68 78 76 88 88 69 64 51 76 71 89 89 73 93 77 58 87 85 90 73 80 81 71 63 77 86 89 86 90 74 96 41 
1552 62 59 56 61 37 43 50 35 64 80 69 70 64 57 54 72 65 78 76 90 90 83 72 70 61 65 78 86 74 67 65 78 62 69 98 79 88 74 59 50 60 90 92 83 76 77 54 68 81 74 94 99 97 105 74 32 86 100 86 93 103 94 74 7 
