0 97 86 102 103 103 118 116 97 108 116 116 108 101 103 119 122 
0 87 104 98 112 104 115 113 115 102 119 115 119 122 108 105 121 
0 99 116 119 115 116 118 122 112 106 116 114 110 104 121 115 105 
0 108 113 112 107 110 111 106 126 113 114 111 105 101 105 108 110 
0 109 113 106 105 108 129 98 110 104 115 119 114 107 118 109 105 
0 103 113 104 112 95 119 123 102 109 107 116 122 118 118 115 129 
0 107 104 108 105 104 106 110 113 101 107 113 115 101 126 118 120 
0 100 101 108 108 112 127 111 114 94 111 112 115 112 117 118 113 
0 92 88 110 108 107 106 119 125 100 109 113 114 115 121 114 130 
0 92 106 101 105 103 102 118 101 103 124 114 107 103 108 118 117 
0 102 107 96 88 106 108 113 125 99 115 109 113 114 107 116 111 
0 91 98 112 104 109 101 124 103 99 131 124 107 107 108 124 120 
0 105 94 97 99 103 116 119 117 102 112 111 105 103 121 121 99 
0 103 89 103 98 115 128 117 116 109 108 109 120 106 114 109 123 
0 93 99 118 103 110 112 125 99 118 118 114 125 111 123 117 106 
0 103 96 106 103 102 109 125 112 107 116 126 109 116 111 122 123 
0 98 109 102 110 116 119 117 110 114 113 114 108 111 112 103 108 
0 95 112 114 95 109 123 111 110 112 105 99 116 112 96 120 120 
0 106 116 108 116 114 121 122 112 94 112 114 128 106 118 114 116 
0 107 110 104 106 115 110 114 119 97 105 129 109 107 112 118 112 
0 87 114 119 114 99 112 114 123 113 112 112 115 104 111 116 104 
0 92 103 114 102 102 111 104 113 107 119 115 121 105 119 128 118 
0 99 107 110 100 103 110 123 101 106 114 118 107 101 115 124 108 
0 107 106 113 110 106 115 114 117 102 117 117 109 98 107 111 107 
0 88 102 105 104 96 107 114 120 119 122 123 111 90 121 113 119 
0 111 116 110 102 103 105 114 119 102 110 119 114 113 107 121 111 
0 111 102 101 102 106 107 110 119 119 107 126 116 115 115 111 98 
0 81 105 110 101 110 109 110 104 117 110 111 116 98 107 116 105 
0 108 106 89 103 93 112 115 103 98 119 111 125 121 117 128 124 
0 94 98 102 105 104 109 112 105 111 123 115 117 107 101 114 111 
0 100 115 116 103 108 113 114 121 109 108 127 108 101 115 106 116 
0 99 106 104 109 93 113 123 118 105 117 111 121 112 127 113 108 
0 88 98 112 108 105 115 112 106 104 128 115 105 113 111 112 102 
0 105 114 119 93 100 128 123 105 105 109 110 122 106 108 108 116 
0 97 116 108 113 96 120 116 105 107 109 114 107 102 108 120 112 
0 102 100 105 99 106 114 119 99 104 105 105 111 110 108 106 107 
0 111 101 106 103 105 108 122 120 111 99 114 122 108 109 116 115 
0 91 105 102 101 98 100 114 103 98 116 109 109 101 98 114 121 
0 84 113 106 107 110 117 121 111 108 110 120 123 106 119 110 126 
0 102 106 101 92 113 124 112 103 98 131 128 109 117 102 121 103 
