0 87 101 85 94 93 90 98 84 99 101 103 96 114 90 90 104 89 92 105 94 109 95 96 90 87 95 93 96 96 92 98 92 82 96 103 110 97 103 98 89 91 92 95 112 91 107 113 90 96 101 104 97 99 105 108 81 90 96 100 85 100 93 111 79 
0 85 92 84 101 94 91 76 90 96 103 100 112 104 89 93 83 106 102 110 105 112 96 99 86 98 103 96 108 98 94 94 89 94 110 95 96 94 100 105 95 91 99 93 78 86 101 104 97 90 99 81 98 106 99 109 97 108 98 93 93 92 78 95 88 
0 98 95 94 102 88 88 90 93 92 93 85 96 91 105 89 96 80 90 97 97 113 101 98 83 98 87 93 97 97 99 103 108 90 104 92 111 101 103 108 90 104 108 99 102 88 106 113 89 86 97 94 99 88 82 107 95 95 100 101 105 95 96 90 101 
0 105 94 98 94 106 95 91 92 86 90 101 99 101 88 93 99 91 102 107 93 103 88 101 97 93 107 97 95 103 113 101 87 88 105 92 92 101 84 96 91 96 106 100 103 103 88 104 88 109 102 93 89 97 97 95 89 97 90 98 98 98 108 95 104 
0 100 85 87 101 91 86 99 91 101 96 93 98 99 97 89 89 100 91 96 111 102 110 113 90 94 106 101 107 96 100 113 98 81 108 92 105 108 97 95 96 104 97 112 101 100 97 103 94 100 95 91 97 95 96 103 86 90 95 85 83 87 91 87 86 
0 84 80 79 79 87 79 89 87 94 101 94 86 107 93 99 99 90 97 108 91 103 94 108 90 92 92 92 90 93 100 103 82 92 95 102 97 103 106 92 88 93 102 82 101 99 100 108 100 93 100 101 104 106 93 104 109 96 107 102 91 102 94 100 94 
0 88 89 93 105 90 98 92 75 90 103 104 95 99 95 98 107 86 103 102 106 103 104 102 95 103 112 97 107 93 103 106 99 90 102 95 99 111 100 100 104 94 101 112 94 108 98 102 90 107 97 90 93 97 98 105 90 95 91 93 81 97 89 88 94 
0 84 80 87 99 104 97 98 97 94 99 99 102 98 105 84 99 95 105 105 103 98 101 103 95 80 100 99 105 91 90 91 94 90 105 94 114 92 100 97 92 102 107 101 107 104 99 95 106 111 104 110 74 107 96 106 104 87 86 97 83 98 95 97 90 
0 92 89 100 90 98 89 102 82 97 99 100 98 99 118 96 100 93 112 102 106 117 110 103 100 97 104 104 100 89 98 93 102 87 105 96 92 107 92 89 90 83 113 99 100 101 93 102 86 98 100 96 96 92 91 98 98 107 102 85 98 92 95 106 94 
0 88 90 101 92 89 87 81 86 86 96 101 100 105 105 96 97 94 95 101 101 100 100 97 91 90 104 96 107 97 98 104 97 92 98 100 107 100 98 96 99 96 96 84 99 99 101 92 96 94 105 91 103 103 105 102 90 88 104 100 98 107 99 90 97 
0 90 96 85 94 80 83 80 88 102 94 99 106 106 86 92 89 104 107 96 96 97 107 98 88 106 105 101 100 103 101 98 104 95 95 109 101 92 116 97 102 96 97 102 92 99 96 103 98 91 106 96 89 99 109 107 92 86 86 90 101 90 98 91 107 
0 99 94 86 88 84 101 105 89 90 89 102 94 96 106 92 82 100 107 99 91 103 105 100 105 92 101 102 95 91 101 105 93 88 83 83 78 97 104 91 92 82 83 105 93 100 100 97 89 90 97 99 92 94 107 99 102 83 95 102 98 90 100 97 96 
0 91 83 101 90 102 110 89 87 95 98 110 95 94 93 94 87 86 102 101 89 103 116 101 90 89 104 104 104 97 103 87 101 95 99 88 89 88 90 78 90 101 102 96 100 83 88 90 95 93 92 107 91 89 96 85 109 89 80 87 104 88 104 105 94 
0 96 93 88 83 93 93 88 90 106 87 111 90 99 99 108 93 89 98 110 103 108 104 116 101 99 108 96 100 104 102 95 94 96 98 98 94 106 100 89 94 93 85 93 87 98 90 97 104 89 88 98 99 100 103 89 92 93 103 93 88 83 95 99 102 
0 89 88 99 91 92 98 105 104 99 102 96 96 100 97 96 108 104 84 95 95 93 113 104 103 93 102 110 90 109 106 100 100 84 97 99 97 102 111 106 107 87 101 95 97 109 108 100 100 104 114 101 103 93 99 106 97 105 112 104 98 101 95 98 99 
0 88 84 100 81 87 96 77 102 90 95 94 93 97 98 107 102 91 92 103 94 97 104 95 99 90 94 108 85 89 102 94 86 108 98 98 89 100 100 105 91 103 92 100 103 99 98 99 87 97 104 108 101 98 106 100 112 97 102 89 94 89 90 95 101 
0 81 90 92 101 86 98 88 89 84 117 105 86 101 105 103 103 102 106 97 90 98 111 106 98 94 94 104 88 93 111 106 95 94 89 98 104 102 100 96 104 97 97 93 96 103 103 108 101 103 95 85 95 107 97 89 102 94 97 94 93 91 95 102 85 
0 105 95 104 83 96 88 78 80 102 98 99 106 109 96 101 101 85 87 83 103 97 111 109 99 84 99 89 109 95 103 103 93 91 95 111 93 103 110 92 86 84 99 100 94 102 91 93 99 85 103 95 89 93 95 108 101 91 99 94 90 103 109 111 95 
0 92 92 102 101 100 95 92 91 85 105 103 99 97 101 104 96 99 91 103 100 96 100 102 97 83 104 99 101 98 98 88 87 90 107 94 106 97 103 98 85 93 101 107 100 104 97 105 82 89 92 96 100 95 87 89 89 90 78 84 92 91 95 93 90 
0 93 99 99 91 89 85 93 106 90 98 104 101 99 87 95 88 98 92 95 103 97 98 92 92 92 95 101 88 93 96 92 90 92 98 108 97 100 84 94 99 83 110 98 92 92 90 98 94 103 102 98 106 97 91 91 86 93 86 100 92 99 100 96 106 
0 92 97 89 93 71 93 86 85 90 93 102 107 93 93 93 103 98 108 111 98 104 102 93 102 87 101 92 101 104 103 103 100 93 107 88 91 90 102 103 103 86 87 111 95 99 109 96 105 95 101 110 94 94 89 99 104 102 101 88 94 103 100 96 93 
0 88 90 100 94 97 93 92 105 88 109 105 96 99 93 104 102 101 103 90 89 102 101 96 89 90 102 94 87 92 100 102 97 96 91 92 100 99 105 109 96 80 85 100 120 95 100 92 106 84 105 109 98 101 98 93 105 95 95 86 106 95 97 97 99 
0 87 98 78 95 87 96 105 103 85 102 93 93 99 110 104 108 92 108 97 93 88 113 115 96 82 106 88 107 93 101 116 112 101 84 98 98 108 112 92 99 94 109 100 107 100 92 102 86 86 105 87 101 97 101 82 96 91 103 99 93 94 87 101 89 
0 97 99 83 91 91 83 86 100 100 113 108 103 94 94 86 85 110 98 99 93 95 92 101 99 88 105 94 94 101 92 89 93 80 95 104 104 97 91 98 82 93 84 86 102 98 93 109 106 94 104 95 102 93 101 94 92 91 110 96 94 101 87 90 93 
0 88 94 79 98 98 101 98 88 90 107 92 102 92 92 116 110 101 94 112 105 102 102 97 106 88 94 111 94 100 88 104 95 100 91 98 105 99 94 98 100 91 96 100 94 101 100 118 91 93 99 92 101 105 104 103 91 80 93 100 100 98 86 93 102 
0 80 102 92 100 85 90 105 105 88 102 95 100 116 111 94 87 93 95 96 86 117 111 96 87 86 105 105 102 91 86 95 105 89 99 107 98 94 90 103 106 82 111 104 105 96 103 95 95 95 100 108 99 93 94 94 91 88 101 120 106 107 97 103 99 
0 104 102 88 92 99 98 87 89 100 106 96 89 106 102 88 86 95 102 93 93 95 96 92 84 96 99 97 88 89 99 99 90 92 92 102 93 102 98 93 99 90 105 92 109 97 95 95 99 96 99 99 111 101 110 101 98 89 104 102 92 93 103 102 101 
0 99 101 102 107 102 82 102 107 101 101 100 100 85 91 103 95 100 95 99 99 105 105 97 91 96 99 91 102 97 89 103 91 91 96 98 92 93 105 102 94 88 104 103 102 109 98 104 100 75 102 112 90 98 111 99 95 93 96 96 95 87 90 98 92 
0 92 94 82 99 83 98 91 94 96 102 101 101 103 92 97 96 93 101 102 102 90 105 103 99 104 104 97 87 97 96 91 96 108 89 99 102 104 98 98 101 99 92 101 99 111 103 97 92 98 97 101 118 90 99 108 95 85 98 98 98 88 101 86 90 
0 92 96 88 93 92 118 97 95 85 100 99 98 105 90 104 113 99 112 98 101 97 96 98 100 96 112 102 106 108 102 114 101 94 96 98 101 92 92 111 92 97 104 98 97 91 98 96 95 90 93 94 93 113 101 98 88 96 93 98 98 95 90 93 98 
0 74 106 95 97 105 98 90 74 95 93 104 101 95 92 98 95 90 95 95 90 107 108 112 94 87 103 111 96 101 93 99 102 97 115 93 113 95 102 102 99 84 100 106 86 98 106 106 97 89 102 107 100 96 93 91 107 103 98 106 87 99 96 94 99 
0 90 104 98 85 100 90 97 96 88 90 97 105 88 101 95 109 91 98 90 96 88 100 102 85 92 104 97 94 102 107 96 94 92 99 99 98 114 107 100 105 99 99 95 107 89 96 93 86 101 111 93 99 97 110 98 98 97 101 102 91 91 91 102 97 
0 86 98 97 91 90 95 84 88 100 107 101 107 91 104 104 106 80 103 94 95 93 102 93 102 82 106 106 108 102 104 85 102 97 100 98 100 89 103 97 101 89 107 95 98 98 106 104 100 87 111 115 96 98 96 100 107 104 102 97 100 101 90 94 87 
0 96 106 96 102 94 87 91 87 91 104 109 108 97 101 111 98 99 89 99 104 107 105 98 98 93 92 106 94 100 90 95 94 89 85 99 101 99 91 107 87 90 105 84 100 93 107 108 102 106 95 106 98 119 106 110 89 83 86 93 95 103 106 97 95 
0 86 82 100 99 90 96 92 85 94 96 96 85 103 84 98 102 88 89 106 100 84 99 105 91 99 102 92 98 93 93 100 91 107 107 122 92 93 99 96 103 104 99 107 103 99 93 100 97 97 100 112 96 88 86 95 103 101 96 102 83 101 91 101 90 
0 85 94 94 75 102 96 87 92 88 96 100 96 107 96 98 98 93 93 99 95 107 101 76 98 101 90 100 99 100 97 99 100 99 96 94 100 97 94 88 110 84 92 103 90 107 99 98 87 89 90 91 98 95 103 104 109 91 87 100 98 97 99 86 82 
0 94 80 107 95 87 101 102 95 86 94 109 94 80 94 97 84 92 100 98 88 98 97 95 91 104 95 92 97 102 95 97 101 90 93 99 98 91 97 92 96 102 104 97 102 100 95 89 104 85 104 104 94 96 94 101 96 91 104 88 92 84 105 101 91 
0 83 94 101 102 93 89 83 83 89 100 108 97 98 92 94 102 95 117 100 101 105 107 86 94 93 101 112 85 94 98 97 83 89 102 90 98 90 91 100 101 96 99 92 100 99 101 77 93 97 96 102 107 101 101 97 96 77 99 99 102 104 99 106 89 
0 88 83 96 94 83 99 96 94 103 92 97 101 79 99 99 92 88 97 99 94 101 101 94 85 93 114 96 111 97 96 94 104 87 104 101 103 100 101 100 98 90 92 117 95 96 93 107 98 87 93 103 97 108 107 94 99 92 99 105 84 93 101 104 83 
0 74 95 94 84 92 97 96 95 88 100 88 99 104 89 94 99 82 95 109 101 105 98 101 96 88 91 86 87 95 96 99 90 90 99 97 97 99 101 107 102 90 92 97 101 107 105 96 102 105 105 101 99 87 91 93 94 95 88 92 99 100 88 101 87 
