436 56 68 48 73 70 68 79 49 52 72 60 57 64 53 69 65 
453 50 48 62 75 46 52 61 54 66 58 49 50 61 60 55 60 
424 46 59 57 70 54 39 78 68 67 74 41 56 74 65 73 45 
464 48 50 66 73 46 52 64 51 54 82 63 60 61 60 76 61 
380 49 71 62 70 59 43 72 65 59 72 64 56 73 64 74 69 
411 54 57 56 70 58 54 70 71 72 76 46 47 93 73 45 52 
408 49 66 71 75 64 53 82 56 74 69 50 69 83 71 65 44 
412 46 69 60 82 62 66 81 70 76 63 60 59 68 55 62 51 
424 47 56 63 79 63 45 71 67 72 62 65 66 73 68 48 59 
419 69 64 50 75 71 63 81 72 42 85 56 76 76 64 63 55 
435 46 73 62 77 64 34 72 63 67 67 34 66 79 51 69 40 
403 40 69 59 69 63 54 66 66 75 80 52 50 74 78 55 63 
387 58 55 57 66 58 45 65 74 78 72 62 60 78 82 50 50 
439 51 67 48 73 63 53 70 66 61 60 28 66 65 55 60 64 
391 64 54 70 97 45 42 82 72 72 67 52 67 56 57 52 63 
397 57 56 73 70 48 48 79 78 64 77 58 67 78 70 73 61 
429 55 54 69 63 72 56 67 66 63 79 48 50 75 61 75 39 
459 47 56 37 73 54 50 76 47 61 71 58 62 70 73 56 40 
354 39 63 54 60 50 65 62 61 67 74 58 52 76 68 57 70 
463 34 64 67 69 51 47 73 57 59 84 45 61 70 62 65 32 
440 36 73 45 70 59 40 64 65 59 83 54 52 72 76 55 61 
387 56 51 70 71 59 50 66 73 55 85 64 75 80 66 73 62 
418 44 39 76 85 63 55 80 62 65 70 70 74 61 63 66 73 
464 42 70 36 78 62 48 80 74 41 91 50 57 66 66 70 37 
445 44 76 60 69 74 31 74 56 54 77 32 60 63 63 77 32 
399 49 35 51 70 67 46 59 75 53 79 59 75 73 75 52 55 
416 51 61 64 83 67 55 71 58 58 68 43 65 76 81 82 45 
495 54 59 41 69 52 27 64 69 37 69 44 56 69 63 60 44 
424 35 67 56 58 57 51 78 54 65 63 47 35 54 74 75 59 
420 48 33 59 65 69 49 76 61 60 73 62 59 73 56 79 56 
421 66 69 68 77 51 53 84 71 60 67 62 57 75 64 46 50 
454 47 53 43 82 54 53 62 61 67 79 61 58 71 59 74 35 
389 40 69 69 63 62 63 64 61 57 73 48 64 73 55 65 49 
376 49 64 65 73 68 60 73 69 61 72 57 71 74 62 69 72 
414 59 53 60 61 79 46 85 72 50 57 34 62 63 64 66 61 
434 34 67 58 90 41 49 81 66 63 68 54 55 71 50 62 60 
417 58 65 64 78 65 34 85 67 64 79 56 49 65 66 56 44 
403 53 45 55 82 53 48 67 78 59 57 55 79 81 61 55 64 
397 50 78 57 77 61 50 67 68 56 84 62 71 83 63 76 45 
402 59 63 73 78 58 52 71 60 79 86 54 73 82 65 65 46 
341 66 74 52 71 60 63 80 75 61 71 73 74 85 61 58 74 
387 52 79 72 81 71 55 78 53 62 77 46 67 90 67 51 36 
385 39 70 58 86 48 47 89 73 58 94 56 73 82 74 70 64 
423 53 61 59 68 55 32 66 72 63 68 55 51 64 67 63 37 
470 26 71 63 72 68 52 83 68 52 70 42 60 55 75 61 47 
445 46 55 50 59 62 37 81 84 61 65 41 60 89 74 57 55 
415 56 55 55 82 66 38 68 54 51 69 47 67 74 58 59 63 
427 50 59 37 75 80 31 76 61 58 82 57 64 59 66 59 54 
448 54 36 58 82 66 46 71 65 67 78 71 67 64 55 71 48 
405 59 66 52 77 50 48 72 72 73 68 71 68 83 57 49 56 
416 39 68 53 74 65 57 65 64 62 53 48 68 72 64 69 54 
382 46 65 61 77 69 55 50 66 68 76 69 56 75 61 78 49 
409 43 68 67 71 71 47 68 61 91 83 44 61 80 54 53 44 
395 65 58 65 69 66 34 68 74 71 66 61 61 81 78 63 59 
360 69 78 60 78 71 52 84 73 69 82 63 71 68 74 64 62 
467 46 56 62 75 57 50 61 53 67 84 30 56 59 65 54 46 
386 63 65 60 84 47 54 78 80 65 66 42 71 98 62 68 62 
441 61 76 55 74 63 51 64 71 62 58 47 51 76 52 57 56 
421 40 64 73 75 61 35 70 56 53 76 47 66 59 52 73 54 
431 63 62 69 79 57 48 77 64 58 75 44 65 82 48 54 45 
