936 9 57 54 10 59 49 17 60 56 55 46 57 4 57 49 18 
988 5 46 41 16 40 39 41 58 41 58 54 65 13 59 44 20 
964 6 42 47 22 47 33 40 29 56 36 30 46 3 42 62 8 
1044 2 41 37 0 45 41 51 51 40 11 44 51 5 66 55 7 
996 3 34 35 2 34 25 3 45 36 26 27 46 1 41 45 14 
972 12 35 50 11 49 30 38 65 49 52 36 59 16 41 75 15 
996 3 37 40 3 57 45 27 48 50 12 23 29 16 52 52 2 
956 5 47 29 18 46 37 37 46 45 60 53 54 5 58 37 15 
996 4 40 39 4 45 27 28 48 44 37 46 55 2 64 66 9 
856 22 56 53 21 44 16 51 67 47 36 52 53 5 44 27 14 
928 0 48 48 7 39 53 28 45 43 55 56 58 8 52 44 9 
1028 1 42 40 0 21 33 35 62 23 20 42 29 6 41 49 27 
956 15 37 34 3 30 47 39 49 44 27 52 71 0 45 49 10 
904 11 73 70 7 54 39 46 52 58 38 36 58 9 67 52 19 
972 2 41 38 14 56 32 63 64 48 38 20 61 11 52 46 13 
936 2 28 53 5 52 46 40 57 52 54 40 55 6 59 49 6 
972 2 53 62 4 39 38 25 39 36 42 40 35 13 56 47 12 
972 14 47 45 17 47 56 35 60 30 59 31 50 11 67 73 25 
916 0 54 37 5 41 39 44 49 42 32 36 51 2 44 69 19 
984 4 45 29 6 40 26 26 28 56 44 35 36 2 52 45 7 
848 12 58 44 20 62 55 37 72 48 38 61 58 23 55 70 39 
948 16 29 26 17 44 42 49 57 67 33 48 52 21 42 52 17 
1036 3 44 40 8 43 39 54 44 44 40 40 54 13 68 41 12 
980 7 38 45 11 48 41 40 56 51 59 41 50 27 51 59 17 
988 3 38 48 6 42 32 31 49 25 10 27 50 11 43 48 12 
928 12 36 32 2 55 39 31 46 56 41 45 45 6 42 55 13 
1004 1 43 47 3 32 19 31 42 40 37 41 35 5 59 46 3 
1124 6 26 34 4 38 20 28 39 31 41 19 40 3 47 30 14 
984 3 58 48 2 19 36 35 46 36 43 42 34 18 44 54 27 
1048 3 43 37 2 39 24 39 46 39 20 26 31 10 51 46 10 
1052 6 52 20 0 37 30 30 50 35 27 29 31 3 50 39 9 
1092 7 36 37 3 44 31 11 61 58 20 16 42 3 22 36 6 
992 3 29 37 3 43 27 40 46 37 30 29 44 17 50 49 10 
876 9 44 50 12 74 47 44 56 31 39 62 65 18 50 53 16 
964 14 52 39 1 51 32 44 36 43 64 31 58 2 43 38 18 
912 1 38 23 3 53 54 37 39 40 32 40 34 6 42 49 21 
1020 3 38 43 1 36 39 17 27 41 34 36 61 8 43 63 5 
988 30 55 50 13 45 46 30 43 35 24 41 56 6 77 39 28 
980 3 43 54 7 43 39 20 43 31 29 35 45 24 52 45 13 
912 12 58 39 0 56 47 41 70 53 34 49 58 15 45 44 18 
