0 102 103 84 96 103 87 115 96 101 108 91 84 102 98 102 103 
0 96 87 89 98 99 96 97 105 100 117 98 92 105 109 98 101 
0 92 86 97 90 88 91 96 108 101 110 91 105 100 104 99 93 
0 81 95 89 114 89 88 121 100 98 116 95 101 104 92 106 98 
0 98 93 96 110 109 102 90 98 86 98 96 101 115 96 95 100 
0 84 98 92 103 101 108 100 110 106 104 108 91 107 99 95 105 
0 89 109 94 114 96 103 94 94 98 96 90 87 98 105 92 108 
0 101 111 103 101 102 94 107 102 111 99 94 102 104 101 100 106 
0 97 80 101 95 93 94 94 102 93 92 97 110 97 102 101 99 
0 96 88 101 91 93 100 106 89 86 106 86 103 103 106 82 102 
0 92 97 80 107 92 94 104 111 86 104 86 96 97 102 103 101 
0 86 95 100 92 95 102 96 108 100 82 104 106 106 107 89 104 
0 108 84 87 105 94 93 95 94 96 110 92 94 95 109 105 104 
0 81 98 100 96 97 88 103 102 97 110 101 101 106 108 93 103 
0 86 82 101 104 89 95 93 108 106 103 94 110 106 97 99 98 
0 95 97 93 114 107 99 98 103 91 104 83 96 107 95 84 98 
0 87 93 80 106 107 90 109 100 103 106 85 99 99 96 96 95 
0 87 105 91 107 99 88 99 102 101 95 104 108 92 106 112 88 
0 93 84 100 102 94 105 98 96 107 98 94 108 103 98 99 104 
0 89 96 86 102 91 88 94 88 92 103 98 98 104 94 100 98 
0 86 90 96 97 93 93 90 90 97 109 88 97 94 100 101 102 
0 88 116 97 99 95 85 107 110 90 99 95 94 107 99 104 101 
0 106 98 98 104 90 97 104 103 97 96 88 89 90 108 94 109 
0 87 106 117 104 105 109 98 108 97 109 98 94 89 96 110 101 
0 96 108 104 96 95 101 92 99 93 91 85 118 99 95 100 91 
0 98 93 107 103 85 94 90 101 101 106 91 99 99 104 96 98 
0 91 95 75 105 98 108 103 96 98 100 97 87 104 89 97 102 
0 88 94 98 103 89 105 99 103 105 105 98 99 95 94 95 96 
0 95 97 97 106 88 91 97 108 99 108 91 90 107 96 104 97 
0 94 87 104 95 93 97 104 100 98 108 98 105 93 93 102 86 
0 103 110 105 93 94 105 101 104 85 103 85 94 112 109 99 98 
0 106 92 93 111 102 90 95 103 109 97 97 98 95 107 113 113 
0 86 102 84 103 90 113 103 95 100 117 91 97 100 105 88 105 
0 100 100 92 107 102 94 100 95 98 100 95 108 108 100 95 96 
0 99 99 108 101 85 100 101 101 102 102 103 103 98 96 106 114 
0 89 112 93 88 92 96 102 93 101 94 101 99 95 108 100 100 
0 83 108 102 118 104 95 103 95 96 88 84 102 102 108 96 107 
0 86 95 91 97 102 95 107 103 106 98 98 102 88 97 96 101 
0 92 93 93 105 95 84 112 96 96 99 103 96 114 85 110 99 
0 103 110 98 104 97 97 98 108 105 93 96 98 98 95 94 94 
0 90 89 94 103 97 96 105 95 90 103 104 98 102 103 101 97 
0 94 100 100 110 95 94 96 97 107 98 109 97 98 106 104 101 
0 94 104 97 102 96 93 101 95 108 105 96 100 101 103 109 103 
0 96 86 89 103 90 90 105 96 100 93 89 104 104 108 96 121 
0 101 98 108 106 90 92 88 98 101 90 110 103 102 90 101 90 
0 98 92 112 110 90 85 107 108 91 98 91 108 101 96 101 110 
0 98 119 96 99 103 102 94 98 99 112 101 98 93 110 101 104 
0 91 81 85 94 90 93 99 95 102 89 88 93 104 102 96 105 
0 93 95 100 107 90 107 109 104 99 109 101 97 102 107 88 103 
0 96 90 89 94 97 110 106 113 92 111 95 94 110 100 97 89 
0 91 104 92 99 97 101 109 96 112 107 91 99 96 108 106 105 
0 88 91 96 103 95 104 110 110 92 103 88 83 95 104 99 107 
0 90 89 85 92 100 88 108 94 109 89 91 98 105 96 101 92 
0 97 98 93 103 85 99 94 101 89 106 94 92 108 98 87 89 
0 101 88 96 98 105 82 107 96 92 103 107 96 96 101 91 97 
0 85 90 101 94 96 110 106 95 102 108 93 99 96 95 111 85 
0 89 94 94 85 95 104 103 109 95 108 94 108 115 105 97 102 
0 86 96 88 93 98 94 103 111 97 98 111 94 98 88 93 95 
0 97 96 103 106 102 86 99 94 102 94 104 98 97 100 108 104 
0 100 92 106 110 90 85 96 98 96 105 97 100 106 101 107 104 
