219 75 77 67 29 78 100 80 56 86 85 84 70 69 77 74 39 
237 74 79 63 51 82 79 84 70 87 86 77 68 90 80 84 50 
262 76 81 65 16 70 100 81 70 72 91 74 49 76 91 82 31 
214 56 70 65 38 82 99 63 69 70 82 88 53 67 91 87 33 
217 71 71 83 59 85 89 88 46 72 87 77 46 81 83 97 71 
236 57 66 71 45 71 79 80 53 76 85 85 51 75 79 84 53 
191 70 81 79 57 71 74 78 65 72 84 87 61 88 89 69 53 
212 76 73 68 55 76 89 83 63 73 90 83 49 70 98 63 40 
234 73 77 57 55 79 82 81 66 88 90 84 54 74 75 72 68 
190 67 75 62 57 84 78 90 61 85 87 90 64 67 91 73 44 
233 58 80 71 68 75 92 83 56 81 93 95 72 71 73 86 28 
200 57 75 67 39 69 87 72 50 76 79 88 65 65 79 80 45 
225 50 60 70 57 76 77 59 71 80 82 71 51 83 90 82 41 
207 83 85 71 50 79 90 82 59 81 78 81 39 78 89 81 48 
203 66 93 75 54 80 98 95 71 75 100 91 60 81 82 75 66 
183 67 67 65 49 82 78 85 59 72 79 107 42 79 85 83 51 
212 76 74 53 49 76 80 63 71 85 101 81 58 71 79 76 55 
227 57 78 89 54 85 80 90 49 75 100 87 55 77 89 79 48 
273 53 65 54 44 53 63 85 62 77 102 79 73 65 85 91 43 
228 59 73 66 74 89 93 91 40 92 86 73 47 73 90 69 33 
245 42 79 53 66 74 95 91 51 86 82 98 62 62 86 73 49 
260 61 83 83 36 70 82 95 57 75 84 73 33 75 79 76 19 
261 83 85 66 44 82 77 70 57 78 79 87 61 64 94 85 46 
228 69 82 78 17 83 84 83 66 81 99 69 45 80 80 79 38 
220 70 82 73 57 86 87 68 76 68 88 78 77 86 94 77 46 
239 73 82 61 50 80 92 94 50 92 91 94 66 74 91 75 37 
212 84 69 84 47 69 91 74 50 81 89 88 62 68 87 90 26 
233 72 63 67 30 63 84 80 67 83 100 91 74 70 82 72 58 
237 72 77 67 52 69 77 74 69 71 98 80 67 74 82 79 27 
216 74 81 77 48 81 72 85 57 86 91 86 49 67 86 79 50 
246 65 65 77 29 72 93 85 65 76 83 88 63 85 67 52 48 
247 62 70 75 29 80 87 86 67 76 94 84 60 87 87 70 50 
208 71 80 63 33 68 86 86 69 86 80 93 41 91 75 96 43 
243 66 71 58 51 76 99 87 74 71 86 81 63 70 72 86 21 
199 83 63 87 61 75 98 88 74 75 86 79 51 85 78 91 51 
212 73 63 60 41 76 82 92 71 81 87 83 53 62 89 76 31 
231 50 68 66 44 76 80 83 56 84 95 88 66 70 81 83 47 
217 60 72 75 57 66 89 82 57 89 77 99 58 86 90 79 47 
213 50 77 56 51 97 87 77 58 85 100 84 48 63 75 63 42 
227 76 64 66 58 77 91 95 68 66 89 81 52 70 83 82 37 
