0 91 111 86 110 98 109 103 103 97 102 99 109 97 91 105 110 
0 97 96 90 103 107 101 110 119 102 113 113 109 102 102 95 108 
0 93 111 116 93 90 109 105 103 98 108 98 108 106 99 100 115 
0 117 104 96 93 118 110 115 108 108 106 101 110 93 100 105 102 
0 90 100 99 114 101 104 127 95 99 113 108 101 104 100 93 110 
0 91 103 96 107 98 100 107 94 111 94 99 95 113 111 108 99 
0 103 97 105 104 94 122 103 103 92 105 102 110 98 98 106 103 
0 100 94 100 105 97 104 105 112 106 117 114 98 114 104 107 109 
0 92 86 102 101 99 113 111 100 98 111 94 112 91 110 110 101 
0 101 93 107 101 103 100 109 103 105 100 103 114 104 106 107 108 
0 111 98 104 96 95 108 107 102 97 96 106 106 107 104 109 100 
0 107 100 101 94 112 99 116 107 105 120 104 109 100 115 115 112 
0 94 104 111 100 95 114 109 109 113 90 95 96 101 102 108 105 
0 86 104 98 110 87 112 105 99 109 96 107 108 125 115 108 99 
0 98 84 103 99 110 104 105 98 97 108 107 99 115 102 108 104 
0 98 84 97 95 97 96 101 112 98 106 99 115 110 114 105 117 
0 89 105 96 111 96 103 97 91 97 97 101 98 120 100 116 114 
0 102 105 107 118 104 95 88 102 107 97 92 97 107 108 94 97 
0 103 110 90 101 96 102 99 101 107 114 106 105 115 103 116 99 
0 103 99 98 100 97 105 104 91 113 103 100 106 104 112 92 108 
