0 86 91 98 110 93 100 107 106 99 88 105 97 92 95 108 90 
0 90 91 97 91 94 112 109 101 101 104 105 105 90 101 94 94 
0 99 99 103 96 107 98 98 94 98 92 94 93 91 99 105 103 
0 101 103 96 90 90 106 97 99 114 98 107 106 113 116 108 129 
0 84 97 87 86 89 104 94 97 89 98 104 118 92 96 100 106 
0 83 98 107 102 95 101 108 100 103 111 108 88 93 88 107 88 
0 90 97 95 98 92 107 98 102 82 102 105 104 100 100 98 107 
0 86 86 92 94 107 105 104 93 89 98 102 105 97 83 93 105 
0 100 95 93 108 95 104 115 90 99 85 109 111 96 107 98 112 
0 91 92 104 108 88 94 97 97 95 107 107 104 92 104 99 95 
0 91 101 97 90 89 92 99 93 94 96 97 92 88 97 92 103 
0 99 104 103 103 87 100 101 102 96 100 109 99 93 102 103 92 
0 101 109 94 103 93 102 96 99 104 108 96 101 96 95 103 98 
0 71 88 87 86 89 107 94 101 94 94 91 117 96 98 97 110 
0 100 95 96 88 104 101 99 97 102 94 93 102 85 94 93 105 
0 98 103 100 86 99 109 99 92 86 100 108 105 101 102 103 92 
0 97 87 107 85 101 108 91 91 92 95 103 88 95 106 105 98 
0 88 104 96 90 96 94 105 106 100 108 103 105 101 104 98 101 
0 106 101 103 87 92 109 99 105 99 98 94 101 88 95 97 98 
0 101 100 99 97 101 104 107 101 107 105 101 99 103 104 88 118 
0 90 87 86 77 98 104 109 98 101 102 118 93 98 94 95 98 
0 102 96 90 80 93 101 110 99 98 100 102 97 83 87 108 100 
0 83 75 90 93 91 93 104 116 87 104 105 111 86 103 114 99 
0 102 122 106 91 83 103 94 97 88 100 104 102 105 102 103 102 
0 96 105 96 88 105 105 100 101 96 106 107 100 89 99 103 102 
0 101 99 87 105 88 114 104 103 94 105 102 109 93 97 85 110 
0 79 86 89 91 93 105 115 99 95 114 101 98 100 99 85 90 
0 89 86 89 100 95 103 98 90 95 106 109 91 81 95 98 97 
0 102 104 103 95 103 102 108 100 100 99 107 96 100 104 101 112 
0 88 88 95 92 105 104 98 105 93 93 95 98 94 96 93 105 
0 109 103 86 85 96 93 99 96 99 99 95 99 108 107 90 85 
0 101 96 95 90 88 99 97 101 94 92 102 102 116 111 101 86 
0 99 105 90 102 90 113 100 87 108 113 100 82 89 90 86 101 
0 104 95 94 89 94 100 103 99 99 101 94 105 98 96 105 104 
0 90 92 93 86 99 100 124 103 92 114 95 81 110 100 99 100 
0 88 98 97 104 88 95 107 106 92 109 101 99 92 92 97 94 
0 84 91 83 106 100 109 106 101 85 96 108 98 98 92 103 97 
0 95 92 111 95 97 108 99 95 91 93 104 102 89 98 102 113 
0 92 94 105 93 96 111 88 106 84 105 118 89 96 107 106 108 
0 97 96 100 90 87 102 96 102 97 113 97 103 95 94 80 88 
