360 3 1 2 1 
352 1 0 1 3 
356 1 3 3 1 
328 0 2 0 2 
312 1 2 0 3 
320 2 0 0 1 
336 0 2 0 0 
340 2 0 1 3 
332 3 2 2 3 
356 1 0 1 1 
352 0 1 1 2 
348 1 2 2 2 
348 3 2 2 1 
344 2 2 3 1 
352 1 1 1 1 
372 0 0 0 1 
340 3 1 2 1 
356 1 3 0 0 
332 0 1 0 0 
352 0 0 2 2 
364 1 3 2 3 
336 1 3 2 0 
360 3 2 1 3 
360 3 0 1 3 
328 0 3 2 2 
300 0 3 2 2 
340 1 1 3 1 
328 1 1 3 3 
372 2 1 3 3 
356 1 2 1 2 
360 3 1 2 1 
376 0 2 3 1 
360 0 1 0 2 
324 0 2 3 3 
340 2 2 2 0 
344 2 2 1 3 
328 0 1 3 2 
324 2 0 1 1 
356 3 2 0 0 
344 3 3 0 2 
