0 92 96 104 101 102 105 100 86 89 83 88 104 97 97 104 91 80 94 93 98 99 92 99 105 91 95 100 88 106 106 100 108 94 101 108 102 95 115 100 104 103 108 94 94 94 91 90 100 96 107 107 102 99 88 94 103 92 105 101 98 102 86 93 93 
0 93 101 85 86 92 86 78 91 93 95 101 87 91 91 103 100 95 103 87 101 98 91 107 85 96 110 94 94 94 100 85 92 94 90 102 97 107 93 99 87 97 105 114 103 113 110 91 90 98 93 107 94 101 99 90 93 97 108 90 98 91 86 96 85 
0 98 106 93 97 98 96 98 89 96 97 90 111 97 101 100 93 95 101 98 95 113 106 91 85 87 95 101 101 91 84 99 91 93 102 104 101 109 107 103 103 93 97 98 102 91 106 114 103 92 110 103 105 96 110 96 89 99 95 105 95 90 87 91 92 
0 91 92 90 93 105 106 95 86 90 101 97 90 109 102 105 104 103 82 87 100 102 105 106 100 86 99 109 103 104 107 93 100 88 96 101 97 109 93 90 100 86 105 107 102 104 120 104 101 93 99 95 96 100 95 106 90 93 92 108 103 94 95 90 109 
0 91 91 84 82 91 87 97 84 96 111 111 98 94 102 106 105 89 96 102 93 102 95 103 101 99 97 104 105 99 98 108 100 102 105 105 93 103 86 93 92 101 104 103 91 95 103 97 97 105 94 98 101 94 90 97 104 94 96 100 102 91 109 93 94 
0 90 91 90 102 93 89 105 89 99 104 105 82 92 97 98 88 85 92 108 108 89 93 98 85 95 108 94 88 99 90 91 93 89 96 104 88 105 97 103 88 97 86 102 99 96 92 110 93 96 109 91 91 95 94 104 90 90 104 99 87 91 86 92 99 
0 99 96 89 82 84 91 104 84 100 106 113 101 88 104 86 104 87 104 108 109 102 91 111 105 94 95 89 94 94 105 97 99 101 100 105 104 111 93 94 101 91 101 102 103 96 96 94 91 87 102 97 89 103 111 105 98 98 102 101 103 93 102 90 89 
0 95 107 89 105 96 89 91 102 96 99 99 108 96 96 102 103 92 101 107 99 107 111 94 97 86 98 107 96 105 93 85 99 99 86 96 105 104 102 90 105 91 109 98 88 108 106 91 85 97 102 101 101 94 102 98 102 91 105 92 97 96 90 102 96 
0 106 98 84 88 79 88 94 92 96 103 99 95 93 103 95 91 97 107 105 99 87 75 77 91 91 100 84 94 98 84 92 101 98 101 104 96 93 108 109 98 89 86 102 93 96 88 98 103 90 86 105 88 84 92 95 85 81 104 112 103 83 94 83 97 
0 86 79 97 106 98 97 99 105 92 104 104 100 104 96 94 93 83 107 108 104 114 99 104 103 94 89 100 89 96 100 102 102 94 103 96 95 99 88 91 97 97 90 88 103 96 98 99 105 87 104 104 96 97 86 109 96 83 100 91 100 105 95 98 87 
0 99 89 89 102 94 83 95 106 90 102 103 105 102 103 94 92 91 107 109 109 87 102 99 104 100 98 79 107 93 93 97 102 96 98 101 97 104 87 103 97 94 98 103 99 111 98 96 104 88 99 116 90 102 96 103 83 93 112 88 104 90 96 104 89 
0 90 82 87 74 83 80 92 92 95 92 91 102 104 102 88 99 96 106 96 102 100 101 104 102 97 98 100 106 99 103 108 95 100 104 97 92 95 105 113 98 97 92 93 98 104 90 103 93 98 91 105 102 100 89 108 93 96 86 92 100 92 102 94 110 
0 84 104 96 102 83 88 81 94 91 88 103 100 90 103 101 99 97 102 102 87 106 98 95 96 92 101 104 100 87 101 95 112 81 100 94 99 92 108 113 103 84 103 103 103 97 100 99 98 92 113 107 93 88 104 99 97 94 92 91 98 96 100 95 88 
0 105 88 97 83 84 93 91 99 108 112 110 101 88 104 102 90 95 93 107 100 102 95 96 94 92 103 88 98 105 99 90 99 89 99 98 109 107 99 95 90 105 105 99 89 97 103 85 99 101 108 108 100 101 93 97 96 93 87 108 96 97 100 87 94 
0 91 85 92 98 90 96 108 87 93 100 109 98 93 92 93 107 105 106 93 106 84 90 93 109 106 97 94 99 95 91 102 93 88 109 96 94 105 106 103 99 85 89 102 108 89 99 99 101 96 109 105 105 103 91 98 100 100 106 112 114 94 106 118 103 
0 102 92 83 102 103 84 96 88 100 93 89 111 100 106 103 98 91 99 102 95 94 105 110 79 90 89 98 112 101 96 92 97 84 92 86 101 94 99 104 98 94 91 94 96 102 103 103 99 89 94 98 114 87 91 89 97 94 96 106 102 106 106 91 94 
0 92 97 94 98 96 98 101 97 91 103 95 98 90 96 100 96 83 98 109 96 96 99 102 95 92 80 91 101 101 96 95 107 75 98 95 99 94 97 102 101 81 94 101 90 97 94 100 92 93 94 97 97 89 102 101 98 104 97 96 111 95 110 90 95 
0 101 106 100 93 100 90 96 89 103 94 89 97 101 94 101 98 91 99 87 100 110 119 108 97 98 98 102 107 97 105 107 92 97 97 100 96 98 109 93 92 99 87 93 95 101 87 99 92 91 100 87 90 114 96 107 98 90 102 99 97 88 89 93 107 
0 89 81 89 94 92 98 90 94 99 93 95 95 89 102 109 96 107 94 85 110 100 94 99 102 97 110 91 98 101 93 103 106 90 83 95 99 93 95 92 102 100 90 99 99 94 93 97 103 98 105 100 97 95 104 98 103 80 93 99 101 97 84 94 100 
0 82 88 91 100 99 86 92 84 91 86 96 86 75 94 101 104 100 97 97 89 102 102 98 83 93 89 103 108 90 92 106 106 95 88 96 85 91 110 100 97 97 105 96 89 97 100 113 83 95 110 92 100 95 96 92 99 90 102 100 94 91 94 97 92 
0 97 106 107 78 94 94 96 91 95 99 112 88 99 105 94 102 107 89 101 111 104 105 103 102 104 115 101 112 100 103 88 96 92 99 107 95 105 92 89 99 88 95 87 96 97 89 102 87 99 101 103 97 95 103 95 93 94 104 81 92 100 98 97 98 
0 78 87 103 83 92 99 104 96 100 96 105 113 100 94 93 103 90 90 96 104 101 89 110 98 104 93 95 91 98 90 109 99 93 95 94 103 100 90 100 94 101 92 95 108 106 107 98 107 90 91 89 93 93 96 104 96 90 104 96 99 92 92 83 105 
0 94 80 94 77 93 86 99 96 99 93 103 98 89 104 98 92 81 99 94 82 90 88 110 99 98 99 96 95 106 90 99 95 87 102 101 108 94 91 100 98 93 102 99 111 112 99 101 98 98 108 96 109 102 93 104 100 96 96 95 99 90 92 96 95 
0 97 93 94 95 94 89 97 103 96 98 114 107 96 94 108 100 78 96 99 87 84 99 104 93 90 100 96 86 87 102 91 89 100 84 101 95 104 85 97 102 94 98 89 100 100 111 94 97 97 105 94 90 99 101 94 91 96 112 87 106 113 101 93 88 
0 80 94 102 97 91 92 97 100 107 111 96 104 95 109 93 88 76 94 98 109 91 97 101 107 89 94 89 101 102 96 97 92 91 99 93 107 99 102 102 98 94 106 104 97 103 104 100 95 107 109 98 106 110 98 87 95 84 92 99 90 92 101 87 92 
0 82 91 93 101 95 101 103 102 84 88 95 114 97 106 94 93 98 105 104 103 99 95 97 88 91 89 99 102 105 86 99 103 92 100 97 90 106 99 92 97 103 90 95 100 103 109 87 87 102 103 91 86 109 95 102 101 92 87 103 115 99 99 99 90 
0 80 87 83 91 90 101 85 90 96 102 96 103 93 98 87 89 92 95 109 103 107 91 103 86 99 99 102 114 102 99 100 84 98 101 96 105 107 97 95 107 95 97 110 108 98 102 97 109 94 97 86 116 97 96 101 100 92 95 99 100 93 98 87 99 
0 89 102 89 91 77 92 92 80 102 109 82 80 91 103 102 91 100 94 93 103 103 106 97 100 94 94 93 97 97 101 101 100 97 87 104 109 102 97 97 104 102 93 116 104 99 104 104 95 90 106 101 108 92 93 97 93 91 109 84 105 105 97 69 99 
0 93 107 100 90 95 77 88 85 87 105 97 90 91 98 104 95 88 102 91 92 100 86 91 103 83 87 102 96 99 96 87 108 83 85 99 87 93 99 89 94 93 88 77 98 98 98 104 110 98 102 85 98 98 101 109 109 111 97 93 94 95 97 93 90 
0 96 93 90 90 106 96 96 82 90 100 95 100 99 95 104 90 104 90 101 110 97 95 95 104 108 106 113 107 98 96 92 90 97 94 94 103 97 102 103 99 89 99 97 104 97 96 95 93 98 101 101 113 108 108 100 99 87 93 91 93 107 98 115 89 
0 100 99 98 107 105 96 93 86 93 94 111 101 96 104 97 100 95 102 86 98 102 100 93 104 89 96 96 108 104 106 97 94 92 90 106 94 114 94 97 96 102 95 95 86 88 106 95 87 107 94 94 112 105 98 98 98 88 102 104 94 98 105 103 83 
0 91 101 93 94 94 96 92 92 80 92 105 91 98 95 98 102 91 108 96 91 109 99 99 88 96 96 101 100 97 104 112 93 105 92 105 115 101 89 100 97 85 111 90 96 85 94 91 93 89 98 108 99 106 92 97 101 90 103 97 90 94 90 95 99 
0 87 88 97 104 94 92 88 94 90 85 100 101 101 104 102 103 98 99 98 101 89 93 106 96 90 110 100 96 104 96 93 103 91 82 103 99 99 90 95 103 95 106 96 95 103 92 108 84 105 109 93 101 90 100 99 89 100 98 91 83 88 87 93 107 
0 85 102 102 103 97 100 97 79 93 96 107 98 100 98 92 86 94 103 101 98 103 92 85 79 100 92 85 97 98 92 97 96 102 99 90 100 98 82 95 93 92 98 103 92 98 102 90 99 89 111 106 100 102 97 91 95 95 106 98 102 99 106 93 99 
0 88 110 97 103 93 95 91 87 90 98 108 98 94 90 118 104 88 82 93 104 100 81 101 91 101 94 97 110 104 100 94 98 92 96 97 102 102 100 105 97 90 104 98 101 88 96 115 89 94 121 102 99 94 98 106 100 78 94 106 87 89 89 97 109 
0 103 90 89 81 83 82 89 97 93 106 95 94 88 97 89 97 94 104 87 97 101 106 99 92 91 91 109 95 95 93 109 103 99 96 98 95 98 95 96 94 95 98 97 93 101 99 93 102 96 103 113 93 100 99 94 86 102 88 91 88 108 93 96 98 
0 99 89 86 91 103 88 97 107 101 100 99 100 94 86 87 97 97 92 93 103 98 93 100 96 92 90 96 98 96 97 110 95 90 95 99 95 98 105 104 97 96 99 96 101 91 101 90 103 99 90 93 100 105 100 96 104 98 103 90 97 88 97 111 102 
0 84 98 86 99 90 95 100 105 89 104 96 96 96 100 89 93 89 95 108 103 107 83 103 107 79 94 109 101 93 94 102 102 79 98 79 96 103 98 104 104 87 101 93 98 104 105 94 92 97 105 98 102 95 91 100 87 104 97 103 94 103 98 98 87 
0 93 100 104 103 86 92 87 90 104 97 113 98 105 95 108 106 82 96 104 87 104 101 93 105 86 87 106 108 97 101 95 94 104 102 103 99 104 97 104 99 97 99 95 99 102 104 108 98 89 110 95 83 100 93 101 113 97 97 98 92 85 107 86 101 
0 86 107 86 88 99 99 103 86 92 98 94 110 96 101 97 102 103 94 111 105 99 99 103 114 94 107 90 97 101 82 108 105 108 92 94 97 100 95 117 97 107 108 99 99 88 93 99 101 100 99 103 93 94 96 96 91 97 99 89 103 98 89 102 94 
0 101 83 104 100 99 93 93 99 93 112 102 104 101 103 96 98 95 113 113 96 105 95 99 84 85 101 89 106 93 93 91 100 90 96 91 110 114 94 87 108 96 82 100 91 97 96 91 89 106 94 97 103 113 98 104 95 89 94 95 80 97 87 104 86 
0 89 95 98 96 79 94 76 91 94 100 102 100 102 102 96 108 90 100 104 88 93 99 90 100 110 112 99 96 94 97 98 93 94 108 109 95 98 108 104 101 84 91 98 94 99 106 108 107 96 100 102 90 84 107 96 91 84 85 85 90 106 94 96 101 
0 84 98 103 94 83 97 98 93 93 112 120 96 95 97 99 92 82 100 96 86 90 111 97 100 88 96 102 93 88 85 95 93 89 100 101 99 85 98 100 105 98 100 98 107 101 85 100 96 99 93 96 96 111 114 101 106 100 101 94 95 98 87 83 101 
0 81 81 80 88 90 89 92 96 98 91 103 103 82 96 100 101 108 98 106 98 102 103 103 92 112 85 108 97 101 95 93 100 89 88 92 102 101 96 102 99 93 104 97 101 97 95 94 101 86 103 112 96 107 105 104 107 90 96 99 103 86 99 107 96 
0 98 109 111 106 103 114 96 94 84 102 96 105 95 98 103 101 95 106 99 90 96 101 93 106 85 96 86 102 105 89 99 101 100 101 103 90 100 96 95 103 91 106 96 98 103 109 104 102 95 103 97 109 100 96 101 94 89 100 96 91 98 109 102 98 
0 94 94 98 98 92 88 94 78 95 82 100 93 101 105 92 96 99 99 114 91 91 90 102 96 92 101 106 106 102 92 96 99 98 110 106 96 95 88 98 100 92 104 114 106 112 100 99 103 102 95 100 95 91 105 98 88 102 99 84 91 91 88 91 92 
0 94 107 93 103 89 110 100 94 102 101 93 99 90 104 98 97 98 104 89 88 98 98 99 91 103 99 93 102 93 101 102 91 99 104 106 102 102 107 99 82 89 104 90 107 98 110 99 89 88 110 93 98 96 88 99 97 93 100 99 85 100 97 93 89 
0 90 95 98 84 82 86 94 89 89 104 103 106 106 107 97 92 90 112 106 111 114 107 103 84 86 100 100 100 93 106 95 88 89 98 98 99 107 96 97 95 86 102 94 94 105 86 96 92 95 98 111 88 108 104 100 95 99 104 104 92 96 96 93 96 
0 84 103 89 89 93 104 83 90 100 100 99 100 104 105 99 103 92 103 97 113 102 80 98 87 88 102 83 83 98 101 105 104 99 91 93 97 92 96 91 95 93 99 103 106 93 95 99 102 91 97 95 104 103 92 113 99 98 104 94 98 91 97 110 89 
0 84 93 98 94 85 96 101 89 102 90 99 103 102 105 94 88 96 103 106 99 96 93 105 91 91 94 102 99 95 102 103 99 98 93 90 106 97 107 101 98 86 87 101 101 101 103 99 102 94 103 106 95 104 99 107 85 101 92 90 100 107 104 98 77 
0 88 96 104 75 91 100 84 90 90 113 89 102 98 101 100 82 101 96 96 107 113 106 91 96 92 108 109 92 98 90 102 104 101 87 98 98 96 103 95 101 102 90 98 101 110 99 104 86 93 88 100 95 100 106 91 97 96 94 84 94 80 101 83 90 
0 95 87 88 88 103 82 98 98 92 104 105 94 85 94 99 109 90 102 92 105 101 97 87 88 90 98 83 98 104 105 98 92 81 106 84 98 103 105 95 104 89 97 97 87 105 86 94 92 93 90 113 99 97 102 95 93 85 96 98 102 101 99 98 98 
0 100 98 98 99 99 93 85 93 92 104 103 99 100 98 103 98 90 100 99 98 105 103 95 88 94 106 105 97 93 83 91 102 98 102 94 88 103 96 100 92 87 110 107 95 87 95 104 88 97 105 101 91 94 95 83 86 93 95 87 95 91 100 103 98 
0 99 90 92 80 84 95 105 98 98 109 99 99 110 104 90 101 91 93 101 97 98 104 92 100 94 88 102 99 100 94 95 88 100 93 93 78 104 94 94 94 96 90 97 93 88 97 94 103 99 92 96 92 99 101 93 101 97 98 100 102 96 98 103 88 
0 100 89 85 93 93 91 89 90 106 101 106 99 109 102 105 98 95 95 94 107 108 101 95 90 105 102 100 88 89 91 91 95 88 100 91 102 104 95 88 101 91 102 102 107 96 99 101 88 88 92 108 97 99 100 96 84 109 100 100 99 90 95 98 80 
0 95 89 94 108 94 101 106 101 101 103 93 100 102 90 107 96 102 96 95 108 93 92 97 90 103 89 93 87 102 95 89 82 102 110 107 88 96 84 90 89 92 89 96 95 84 98 95 102 89 86 110 90 99 103 99 99 97 97 112 108 93 87 83 86 
0 88 79 82 81 96 90 97 78 101 108 90 91 103 99 106 99 90 98 110 102 104 90 112 93 90 101 103 98 96 95 96 97 104 103 90 96 91 94 84 106 94 91 96 91 101 110 112 91 90 110 102 114 94 104 105 96 94 94 86 98 102 97 92 80 
0 88 92 103 92 104 93 88 91 92 94 99 105 108 94 86 100 70 95 113 112 110 98 87 93 97 107 99 102 93 101 107 84 91 103 87 104 98 91 102 94 97 99 112 95 99 97 97 106 90 93 100 97 95 103 91 101 90 104 106 89 90 84 96 94 
0 75 92 76 86 94 86 96 83 93 100 103 95 96 100 104 102 102 92 98 104 98 90 96 102 99 113 92 98 115 96 99 96 94 99 111 95 93 98 92 103 101 101 92 90 104 95 93 95 95 88 98 99 100 101 97 92 96 100 89 100 98 93 94 97 
0 83 104 92 102 89 92 91 93 91 99 101 89 112 97 104 104 96 103 95 97 103 95 100 85 100 90 110 88 103 96 101 99 90 92 112 102 103 82 96 91 90 88 99 105 101 86 95 110 97 82 94 103 105 105 102 97 100 108 106 90 96 91 90 107 
