0 98 103 92 84 106 100 98 92 97 103 104 88 102 96 106 96 108 113 109 100 101 97 97 106 82 99 113 104 86 104 116 105 82 106 106 102 120 104 97 94 95 106 102 96 111 106 102 93 94 103 100 103 105 110 101 100 107 100 105 98 103 108 110 113 
0 84 78 91 98 99 99 98 103 94 104 97 107 109 97 106 117 94 98 96 105 97 113 102 103 99 104 104 108 112 100 103 110 99 99 110 104 111 114 110 116 104 97 108 99 98 101 104 106 91 109 109 85 98 107 102 101 89 90 103 94 96 99 104 107 
0 100 96 89 91 97 86 90 98 85 97 96 89 88 95 100 108 101 115 108 103 113 105 92 108 104 101 117 100 98 105 92 99 108 109 106 108 103 110 100 90 96 87 97 102 99 100 107 94 102 98 111 96 107 96 107 103 90 109 101 102 106 101 97 99 
0 96 94 90 88 101 96 94 98 104 96 96 118 98 101 99 87 106 106 107 99 111 109 97 108 111 106 96 97 109 106 103 95 88 102 103 98 108 97 104 88 102 88 101 106 107 113 105 99 100 88 105 105 106 103 105 97 100 94 98 102 99 97 93 99 
0 94 104 118 102 108 101 104 86 90 103 98 114 95 98 98 108 99 98 109 98 107 106 99 103 101 91 106 83 95 112 103 108 98 87 112 93 93 91 108 107 94 102 97 103 105 112 104 99 83 105 110 103 113 118 99 114 89 104 110 91 94 108 110 95 
0 98 96 100 107 110 103 102 83 90 81 95 97 94 108 101 91 95 99 104 117 107 100 109 100 104 106 108 109 103 118 104 109 102 103 108 111 98 112 94 103 94 113 98 105 104 93 97 103 107 98 94 97 94 96 98 93 93 94 98 113 107 94 86 107 
0 90 114 97 118 105 87 88 83 92 109 94 112 119 108 95 90 94 90 93 109 103 93 104 83 98 92 109 99 99 115 105 106 96 104 94 99 100 100 101 95 95 90 93 92 109 92 104 97 100 101 90 105 90 98 108 113 98 109 98 90 105 103 106 96 
0 105 95 88 97 102 102 107 94 102 98 107 107 112 113 105 108 90 96 94 127 109 97 106 82 95 98 115 111 100 90 106 98 107 103 94 98 89 90 116 111 86 96 94 95 104 98 102 103 101 98 91 87 99 89 89 98 88 105 103 82 95 105 98 101 
0 91 100 90 89 100 96 99 112 103 106 105 91 111 93 107 110 105 102 99 106 105 103 100 106 94 96 112 97 104 93 85 108 88 97 102 100 89 94 100 108 79 96 103 97 104 103 106 99 104 110 105 88 101 108 95 104 102 98 103 97 101 95 116 106 
0 90 86 90 100 105 97 102 92 92 96 98 102 98 109 95 95 109 95 108 114 112 91 105 94 94 95 114 84 109 93 97 93 94 110 105 114 108 94 91 106 111 117 101 112 106 105 98 99 98 112 115 112 110 100 86 95 90 100 106 99 80 109 94 76 
0 89 93 94 97 100 99 107 102 91 105 96 101 101 114 104 94 89 93 93 101 101 108 98 106 91 94 104 98 90 93 108 100 92 102 103 108 93 95 102 93 105 103 101 105 107 113 109 94 89 100 108 92 93 96 84 92 94 91 90 86 108 106 102 98 
0 98 89 96 86 94 94 97 102 101 102 90 98 94 111 99 113 99 105 103 96 94 106 109 113 102 115 105 98 101 102 101 102 85 106 94 105 103 104 104 112 86 105 97 108 107 110 104 109 95 107 119 101 98 100 80 106 99 100 98 95 97 103 96 109 
0 96 97 110 99 91 99 106 108 89 115 105 85 100 103 112 95 112 101 105 95 107 96 108 111 94 94 99 94 110 88 112 94 86 90 106 109 106 107 89 100 102 103 97 109 111 103 99 94 99 113 109 100 98 98 96 102 89 91 105 101 94 105 111 94 
0 94 107 95 109 101 106 91 94 107 107 105 103 79 105 89 101 92 100 119 105 102 99 97 113 97 96 104 102 98 92 98 115 97 97 97 112 94 104 100 112 99 100 106 102 88 103 94 91 102 100 90 105 93 102 99 98 85 98 110 100 108 94 104 95 
0 105 122 98 98 108 92 101 91 105 104 99 96 93 126 94 103 101 107 106 101 104 99 97 101 90 100 103 113 105 114 90 105 98 89 109 108 106 100 106 96 101 97 89 97 111 107 112 99 99 108 103 100 99 85 96 112 94 86 90 101 101 97 93 98 
0 88 88 91 106 93 81 102 95 89 98 85 108 107 104 108 99 90 110 98 115 113 97 110 102 105 88 99 94 108 98 104 107 84 97 106 107 104 107 111 110 93 91 93 101 105 101 118 104 89 103 97 110 112 118 105 94 105 93 114 113 107 101 101 105 
0 104 101 104 95 91 94 103 106 95 92 99 99 88 110 99 113 89 95 100 101 116 97 104 106 98 105 104 101 98 116 102 101 106 104 107 110 113 99 116 91 98 103 105 106 96 97 96 87 112 111 111 108 88 90 104 89 97 97 112 110 93 100 100 105 
0 100 116 89 107 98 96 82 87 114 109 99 101 98 92 95 95 120 103 93 107 98 109 96 99 99 117 104 106 108 92 107 106 88 103 100 104 96 105 106 117 94 118 116 123 103 102 94 111 96 94 98 110 106 101 109 107 90 100 111 100 108 110 105 94 
0 86 101 105 97 103 108 105 99 90 98 106 100 97 95 99 100 91 109 86 101 111 102 102 100 97 104 113 101 99 101 99 98 97 94 113 74 118 104 99 109 100 95 96 107 110 110 103 99 91 98 99 102 101 93 100 102 106 100 89 104 86 93 105 98 
0 98 104 102 106 97 89 91 101 93 112 104 94 100 107 111 94 72 106 101 98 111 99 98 109 99 101 109 103 110 97 102 99 102 96 107 109 100 104 101 115 97 91 103 109 102 100 106 104 113 104 97 105 104 100 94 117 96 97 106 115 105 107 106 109 
0 92 84 94 105 105 106 96 87 92 85 102 106 109 109 96 101 92 97 115 98 105 102 101 97 76 97 103 110 108 108 102 101 78 97 105 100 104 105 107 97 90 101 113 108 98 109 102 89 102 105 105 103 102 96 105 84 100 95 108 87 99 112 104 91 
0 92 93 93 93 94 91 95 98 104 108 107 99 90 91 89 105 90 84 90 87 96 102 88 94 107 117 103 108 95 95 109 97 105 63 101 108 95 95 92 114 95 99 98 105 101 107 109 101 94 94 96 112 106 105 81 105 94 102 92 96 98 115 90 116 
0 98 96 100 93 105 117 98 96 98 104 99 121 97 111 104 93 93 98 106 110 100 97 101 87 94 102 103 102 105 108 113 106 95 99 98 90 103 100 103 104 103 95 106 111 118 103 97 118 88 100 117 97 112 105 87 91 101 93 92 95 89 95 92 100 
0 98 94 86 85 108 108 99 100 100 94 90 104 98 107 89 102 112 105 107 96 101 92 100 89 99 99 105 105 96 106 115 100 92 103 100 111 110 101 101 103 92 117 100 94 112 107 114 100 85 85 102 112 99 101 115 112 91 89 98 91 92 101 109 99 
0 107 97 95 96 101 103 95 107 97 108 112 102 98 109 104 103 97 96 99 109 102 108 104 102 109 93 96 95 99 91 94 85 86 104 104 110 110 109 109 98 98 95 101 106 112 108 101 97 98 95 96 90 98 100 96 105 103 92 100 106 116 103 106 96 
0 112 104 101 98 93 101 93 103 90 94 97 88 84 101 104 103 86 100 102 108 100 97 90 109 90 101 119 98 101 114 113 113 104 96 103 103 92 104 96 114 101 114 101 108 90 99 101 89 102 92 102 106 93 94 98 100 104 98 112 91 95 85 95 101 
0 87 79 76 89 85 94 91 92 99 107 98 100 103 109 98 98 92 109 111 106 112 96 110 115 111 103 108 106 97 107 94 110 100 103 99 103 99 106 102 104 98 96 93 97 93 103 101 101 103 107 97 109 88 119 109 99 102 91 82 99 112 102 100 93 
0 108 101 101 87 95 98 97 108 93 94 101 100 92 112 100 99 88 109 113 95 108 106 97 110 94 114 102 111 107 105 98 98 90 101 97 97 102 113 78 114 107 118 99 112 96 93 109 95 114 94 101 115 104 99 111 112 98 114 109 103 98 115 103 114 
0 92 83 87 91 112 97 97 96 99 106 96 104 124 98 97 89 90 103 91 96 104 106 91 103 96 94 99 104 112 117 102 97 94 103 105 109 107 112 101 110 100 77 104 103 99 98 105 106 109 84 97 95 91 94 107 90 99 93 92 107 110 107 100 98 
0 86 95 91 96 105 110 92 97 101 98 103 105 110 97 98 103 97 99 95 113 118 94 118 106 88 117 105 102 106 105 100 100 105 103 97 111 109 100 93 86 103 83 109 118 112 102 104 101 101 97 100 106 105 108 109 96 99 100 105 95 102 101 98 101 
0 95 95 111 97 93 95 89 89 90 110 108 107 102 97 96 96 97 108 103 99 114 108 116 105 103 104 99 114 92 101 107 105 89 106 107 99 112 90 98 103 106 96 102 97 95 95 105 99 94 94 116 104 98 99 100 85 90 106 106 112 105 95 94 102 
0 94 86 101 112 97 106 81 105 95 103 105 105 110 109 92 97 95 98 103 102 110 110 111 100 109 110 107 87 120 92 108 115 93 101 96 99 96 94 108 111 101 109 100 98 104 100 106 112 97 94 107 97 93 106 110 110 104 99 92 93 100 104 100 98 
0 88 101 95 106 108 90 88 90 99 101 93 101 105 100 99 81 94 114 99 99 104 103 95 102 101 103 98 107 108 111 108 114 102 105 104 102 103 106 113 99 105 119 117 119 105 106 101 102 93 102 115 107 101 91 105 96 87 82 92 80 91 85 98 100 
0 80 92 101 97 95 95 107 104 93 100 92 88 94 99 84 104 98 107 116 92 104 97 108 107 93 104 103 99 123 118 110 108 94 95 95 94 106 106 99 97 100 104 93 105 91 106 101 98 97 107 111 105 99 102 114 104 91 100 105 107 98 108 109 93 
0 97 101 101 100 100 101 99 104 94 103 94 111 102 99 94 100 94 100 118 104 101 107 100 106 98 109 108 90 106 104 104 109 87 107 98 88 112 99 110 110 99 104 94 106 97 101 92 110 90 106 96 109 95 98 98 95 99 109 108 112 94 91 99 92 
0 104 102 105 91 98 113 111 106 111 102 106 102 96 96 104 98 102 107 104 96 104 98 96 110 92 104 105 106 84 100 99 99 110 106 102 117 108 109 112 90 94 105 102 98 104 104 100 90 95 91 84 102 104 106 95 107 100 98 104 100 104 98 86 106 
0 98 93 106 93 95 85 97 89 92 99 108 113 110 110 106 100 92 117 114 114 114 112 94 111 99 97 105 111 107 113 108 92 101 109 115 103 112 109 101 115 95 94 85 112 101 109 93 96 93 109 93 90 93 94 97 91 101 109 96 101 102 105 93 104 
0 86 92 94 75 86 100 89 93 105 115 99 101 99 105 102 95 92 112 109 104 98 104 95 107 93 106 99 104 104 99 106 94 105 105 95 104 97 96 103 105 95 110 102 98 100 101 102 93 104 101 95 102 100 93 108 93 106 99 102 113 92 84 99 104 
0 107 96 107 105 90 95 102 106 97 104 102 100 103 100 96 93 103 107 106 91 100 98 92 98 96 105 107 107 108 104 105 102 104 98 93 96 97 104 104 113 108 96 101 101 92 91 97 105 94 95 95 106 115 100 113 110 106 90 101 94 96 96 94 92 
0 97 100 95 99 96 105 107 96 94 99 105 104 99 101 106 96 88 101 87 99 109 109 98 103 90 96 96 105 108 87 96 97 90 100 109 101 103 95 109 103 102 108 105 92 88 110 103 108 94 104 104 104 98 100 108 100 94 102 106 102 96 100 95 100 
