210 63 74 93 49 82 97 84 62 88 76 77 55 73 86 82 54 
219 82 86 59 40 82 93 88 71 87 92 83 72 77 89 82 34 
244 67 82 78 53 74 82 85 49 74 81 83 73 71 82 68 32 
196 79 83 86 53 74 94 80 75 78 92 99 47 73 84 83 34 
225 70 78 72 29 67 73 92 53 78 92 61 57 62 81 91 56 
208 80 76 63 69 92 88 82 79 89 83 77 50 74 77 73 26 
213 63 68 70 60 78 89 72 57 76 90 90 53 58 74 75 39 
218 63 71 66 41 76 81 88 66 82 101 84 60 69 87 95 44 
230 87 79 70 37 88 97 95 67 83 98 80 63 60 79 63 26 
224 83 88 73 44 106 88 93 62 81 89 82 52 85 75 89 67 
231 62 75 66 48 79 91 75 77 79 83 89 59 68 83 82 59 
222 63 62 68 49 79 86 83 64 92 75 81 46 93 86 68 50 
238 55 98 70 55 65 92 79 70 72 82 83 61 82 78 89 43 
232 80 60 58 46 77 84 89 87 71 94 85 63 77 85 79 27 
205 65 82 63 36 85 104 81 62 78 95 82 57 72 88 80 56 
221 69 84 74 37 77 89 81 67 77 98 77 55 79 84 78 41 
241 81 59 61 35 74 82 91 54 81 85 88 60 70 86 84 39 
233 61 58 53 68 94 96 80 71 86 77 96 68 70 74 72 44 
234 55 79 55 43 73 89 81 67 87 89 77 69 91 94 78 15 
226 76 83 61 46 78 77 84 66 82 76 78 81 68 92 81 36 
205 82 85 70 51 77 97 79 54 70 90 77 53 76 78 84 42 
196 72 65 75 62 86 88 70 61 83 91 92 61 85 85 84 34 
243 69 84 60 37 86 87 89 63 94 99 88 68 64 93 70 38 
233 71 71 67 59 84 87 88 55 84 91 78 58 69 86 73 37 
229 77 67 79 59 85 92 83 43 66 81 73 66 79 78 80 36 
214 61 88 62 50 78 84 83 63 79 95 83 46 70 82 79 51 
220 57 79 77 62 91 88 87 66 68 83 78 58 73 82 83 43 
235 65 76 78 39 81 75 69 75 83 86 85 60 67 92 73 40 
234 82 70 66 51 69 88 83 65 84 73 71 59 83 82 77 52 
205 75 68 58 48 92 85 82 58 80 94 95 77 84 85 78 46 
223 72 77 68 65 70 80 91 60 69 87 79 61 75 89 97 60 
231 73 62 59 38 68 86 80 52 83 89 80 50 79 82 77 56 
245 43 76 71 57 69 89 84 73 87 84 92 51 80 89 77 11 
232 62 87 71 39 83 80 95 73 89 87 71 66 77 80 86 38 
223 76 79 72 58 87 88 93 53 86 83 82 54 72 87 88 43 
241 61 70 77 42 78 82 73 69 84 101 79 29 74 93 77 61 
241 68 79 74 58 79 82 78 58 85 98 88 51 66 90 81 34 
243 63 73 64 54 83 85 76 71 81 78 87 66 70 86 74 54 
225 62 77 74 51 83 87 95 67 69 86 93 78 80 90 91 29 
232 68 67 70 55 82 79 74 52 81 79 79 60 63 86 88 49 
209 69 85 83 58 65 95 75 46 80 92 84 56 67 77 73 44 
226 58 80 54 41 92 100 91 73 70 84 82 65 81 83 80 40 
232 57 83 90 54 80 99 87 61 81 85 81 56 69 78 81 33 
238 63 60 81 46 68 81 75 46 85 91 73 54 85 66 60 27 
225 58 66 82 38 85 91 79 71 87 91 78 54 65 85 72 39 
228 66 70 78 52 78 83 89 53 80 82 77 54 85 78 82 49 
227 62 69 63 74 66 83 82 66 85 83 79 74 83 69 78 48 
207 83 71 66 40 76 89 74 53 71 85 76 59 67 97 89 54 
233 54 84 66 53 75 94 80 64 75 78 83 46 67 84 77 43 
222 49 72 75 61 88 79 80 81 75 87 80 72 76 81 85 48 
195 56 75 60 56 73 77 78 72 69 83 89 65 67 75 81 60 
240 67 75 57 26 87 101 80 55 94 90 89 42 76 85 73 39 
236 81 72 77 47 86 86 90 69 91 83 81 65 65 92 93 29 
211 82 81 81 68 75 77 87 52 77 87 76 62 82 66 71 32 
198 91 73 66 59 78 91 81 52 82 80 90 64 73 76 77 29 
217 60 81 63 53 75 84 89 73 88 92 85 85 79 74 92 34 
246 51 76 77 52 82 75 82 65 70 92 86 52 66 83 73 49 
258 73 93 81 59 71 89 82 60 81 85 69 62 67 87 80 21 
212 70 77 83 57 80 81 81 57 88 91 81 49 86 68 87 47 
226 67 71 68 49 80 87 71 55 67 89 91 64 63 91 79 37 
