552 23 14 22 23 18 39 26 24 28 43 33 42 43 52 59 51 
520 8 20 26 6 26 17 16 30 14 42 33 43 33 50 52 49 
452 21 30 19 24 10 20 41 27 12 33 53 36 61 47 56 61 
520 20 6 12 10 27 29 21 14 17 47 38 30 36 60 51 34 
484 9 14 17 2 18 34 31 23 23 36 26 35 39 45 40 39 
468 6 17 14 9 34 31 46 26 41 32 39 22 37 55 40 58 
456 19 14 35 15 22 25 13 21 36 41 32 30 43 38 47 51 
488 17 10 21 8 28 30 19 11 17 27 43 31 33 40 58 37 
448 4 13 17 17 29 28 28 38 18 33 54 34 41 49 50 51 
476 8 17 21 6 22 38 20 24 35 39 37 37 53 53 55 58 
468 1 9 22 16 32 29 32 34 28 33 43 40 50 52 65 49 
436 33 32 5 15 21 39 28 34 37 45 31 34 40 41 47 51 
440 21 28 10 16 26 31 20 23 21 44 27 41 31 58 56 50 
484 12 14 15 16 18 36 22 25 27 43 38 31 29 44 53 57 
456 25 21 23 25 37 36 35 24 28 43 33 40 41 46 42 61 
484 3 24 3 7 18 20 24 29 38 45 41 22 40 32 46 52 
416 28 25 15 22 20 33 17 32 44 40 37 42 46 44 51 47 
500 5 8 9 2 20 24 26 22 18 31 35 31 42 53 62 49 
492 1 8 20 15 29 36 25 16 26 40 46 30 35 51 39 41 
416 16 24 28 22 17 13 28 27 34 28 46 37 24 58 57 65 
504 9 19 14 14 22 30 10 11 32 57 41 36 38 42 59 40 
456 18 37 20 1 47 37 17 14 43 49 33 25 40 45 49 50 
