0 102 95 88 87 105 107 96 94 110 98 98 98 104 114 92 94 112 108 105 110 102 102 102 108 91 104 103 94 94 114 104 113 101 111 99 94 119 118 106 105 100 99 98 101 104 96 106 108 104 93 103 102 106 96 108 109 107 102 93 106 109 108 109 95 
0 94 95 92 106 105 117 92 90 99 105 103 95 101 109 112 94 93 105 107 105 105 114 104 99 97 103 98 109 106 112 110 95 93 92 99 106 113 100 103 96 107 91 100 112 96 109 108 98 100 105 103 98 97 101 85 86 104 102 107 102 104 92 109 95 
0 99 101 102 93 104 102 98 99 78 107 93 90 88 96 87 111 89 110 102 97 101 96 111 100 108 102 99 100 104 90 96 104 104 117 107 105 102 99 104 95 99 107 100 105 97 98 86 106 104 110 100 99 102 95 90 95 104 90 102 108 109 107 105 90 
0 89 102 109 99 105 98 106 93 103 88 107 111 102 105 103 112 103 118 101 101 107 106 117 103 98 95 99 110 100 104 99 105 102 92 109 107 109 103 110 95 109 113 98 94 112 98 100 104 82 104 106 97 104 104 108 97 95 93 101 94 91 93 102 106 
0 101 107 100 101 99 101 89 88 90 101 102 107 99 106 85 103 104 87 99 107 98 111 108 100 100 97 113 104 106 114 104 97 93 111 106 102 108 100 92 105 98 110 109 110 104 109 96 101 88 107 102 85 116 97 93 109 97 100 95 106 106 101 97 120 
0 99 100 102 90 96 99 92 93 102 94 113 100 120 102 111 97 98 113 102 98 108 97 103 102 111 92 112 110 107 100 91 115 94 93 104 112 110 111 101 100 94 93 119 91 114 105 87 102 93 98 98 113 101 98 99 90 96 91 103 114 115 106 97 91 
0 96 93 98 102 100 101 96 92 101 104 95 99 110 110 95 111 104 85 96 106 95 108 105 100 93 105 108 106 101 117 105 97 101 102 106 103 97 94 99 101 105 107 89 100 84 90 95 100 104 93 104 95 97 104 94 101 95 117 101 106 106 104 111 106 
0 98 100 99 91 102 96 102 101 92 107 109 95 98 95 97 96 98 100 99 96 99 107 104 103 91 105 108 94 96 103 91 97 88 103 100 95 97 96 107 98 100 112 114 98 101 98 97 111 99 101 113 108 103 99 96 105 97 110 95 114 108 95 98 100 
0 86 93 96 88 100 99 110 94 94 94 101 108 88 111 99 93 107 100 96 106 106 109 107 100 86 112 104 101 104 104 97 99 96 105 112 105 106 99 113 103 96 104 105 103 101 96 108 93 109 98 103 103 99 106 101 112 93 96 93 91 89 97 109 111 
0 93 88 107 101 101 103 98 107 88 101 110 102 101 103 103 107 118 87 99 119 101 97 97 100 96 109 105 114 110 96 95 111 101 98 114 100 102 104 97 112 90 87 100 99 107 111 93 93 88 100 101 101 105 107 95 105 96 105 90 106 112 101 93 122 
0 94 82 105 96 100 92 91 102 97 112 96 90 110 104 100 111 104 86 107 101 94 102 102 109 92 108 107 103 103 105 103 98 94 99 101 98 96 93 93 98 99 103 110 115 90 94 86 104 96 98 110 101 120 104 103 88 98 96 113 105 101 103 101 93 
0 109 112 109 115 84 100 91 95 88 124 111 104 97 83 92 92 107 94 101 97 102 87 97 111 106 90 103 106 90 99 103 95 91 93 98 93 109 101 108 100 96 109 95 104 105 98 102 110 106 105 105 106 96 91 105 92 102 92 100 97 116 91 100 104 
0 95 98 98 107 110 110 99 94 95 86 80 106 106 96 95 90 99 98 92 86 103 102 93 88 87 89 109 103 95 104 102 83 104 110 108 103 108 107 91 105 94 105 107 98 98 111 102 104 95 97 100 104 102 109 93 98 101 95 103 107 106 105 106 87 
0 100 96 94 87 98 98 110 85 101 93 104 90 93 98 101 92 91 104 110 102 87 98 105 106 96 115 103 98 93 106 102 95 119 94 88 112 102 92 102 98 102 91 94 97 101 110 102 97 100 102 88 91 104 95 106 106 92 99 95 108 105 109 108 98 
0 79 100 93 104 85 89 91 94 93 107 106 92 100 103 93 95 111 105 104 109 108 96 96 99 102 102 108 101 109 98 103 101 94 97 103 108 99 98 95 93 99 106 91 99 105 98 93 92 99 108 108 104 105 113 92 99 111 112 101 93 109 91 103 99 
0 91 96 96 105 111 103 102 84 93 112 106 106 110 101 85 97 89 105 103 106 96 90 98 107 105 105 103 107 105 104 91 104 115 98 107 97 94 104 95 109 111 106 93 102 99 99 105 95 100 105 93 98 86 90 96 99 98 92 96 90 99 103 97 99 
0 97 96 98 103 107 103 109 96 97 98 102 96 101 96 118 115 84 99 101 94 104 115 102 108 98 100 108 103 106 109 103 105 100 95 111 107 107 106 98 109 105 92 107 107 109 102 109 102 108 103 104 105 105 103 108 115 107 105 108 93 87 94 94 109 
0 83 101 97 90 92 110 101 95 106 103 111 107 101 100 98 97 95 101 102 113 115 102 90 97 89 105 113 98 108 106 104 102 103 107 98 108 103 109 105 109 104 114 118 110 94 99 103 112 82 86 102 106 103 99 90 96 103 100 93 91 102 102 94 108 
0 86 92 88 88 88 109 99 100 85 104 105 102 109 100 98 98 83 101 109 97 101 97 114 93 95 104 109 107 98 101 105 104 102 103 111 96 104 112 103 104 105 105 93 101 106 105 108 103 86 91 101 109 98 106 115 99 99 100 100 84 96 88 88 104 
0 91 106 109 102 103 98 90 96 94 96 107 102 101 107 107 107 95 111 107 94 102 105 93 105 102 104 103 108 100 94 109 99 101 89 103 99 109 105 104 93 91 100 91 107 108 103 97 91 87 95 114 113 113 99 95 83 86 105 108 92 109 102 107 83 
0 78 77 84 105 99 94 100 98 91 87 97 96 96 94 116 93 98 106 105 101 104 99 108 107 102 101 107 109 100 94 101 94 102 98 105 108 110 99 96 107 109 106 100 103 104 108 105 98 100 106 86 100 106 101 101 87 83 99 97 90 104 104 102 101 
0 82 86 107 105 105 89 86 94 97 104 105 116 110 122 97 110 101 107 110 98 95 112 114 99 87 99 101 101 101 107 112 102 100 92 95 114 113 99 91 102 95 100 90 105 112 102 108 97 83 96 92 99 117 105 107 102 95 97 103 110 104 100 108 96 
0 110 94 96 100 105 104 97 107 95 92 96 99 100 109 103 102 99 104 104 106 94 100 111 99 95 97 102 88 109 103 102 100 104 98 106 111 111 98 99 107 86 99 95 99 98 103 93 108 101 79 99 105 96 94 90 106 96 84 101 95 95 105 98 95 
0 101 100 84 106 111 105 93 98 97 111 91 88 101 110 103 101 97 111 101 94 110 110 88 103 110 100 107 106 101 113 106 104 107 99 101 102 110 104 102 92 104 102 106 95 107 104 93 103 97 107 109 111 97 103 90 105 83 105 101 110 96 92 99 109 
0 99 91 102 102 84 95 95 103 85 107 100 104 86 95 101 114 100 107 100 97 105 108 101 96 85 107 107 103 89 113 105 96 96 94 101 95 95 103 102 102 93 105 104 102 117 110 100 98 102 94 111 96 106 105 108 102 100 100 123 105 109 109 103 98 
0 99 113 113 91 103 94 85 91 97 106 104 106 116 107 102 97 102 109 112 105 116 114 112 88 101 97 104 106 101 108 116 101 96 107 110 99 104 114 94 104 115 88 108 95 108 104 99 103 100 107 107 100 92 109 106 100 100 99 94 110 109 104 89 104 
0 108 98 99 107 103 91 96 91 101 105 113 93 103 104 105 96 100 100 117 113 112 95 105 99 93 96 105 106 94 105 101 110 91 105 102 101 123 87 104 105 110 105 108 100 103 98 120 100 95 98 104 105 99 98 107 96 91 98 91 89 102 108 108 101 
0 98 100 119 100 103 93 108 102 107 101 102 107 109 95 101 107 95 93 102 98 92 99 111 105 97 101 103 102 95 98 99 101 105 94 111 95 104 99 106 109 80 99 112 95 104 104 100 102 86 98 104 89 97 98 91 103 102 95 111 104 108 85 110 101 
0 91 107 95 106 89 101 107 102 93 111 96 101 79 111 100 106 99 117 106 97 102 111 95 104 92 107 104 109 107 99 110 120 98 114 98 102 111 114 87 106 90 86 117 109 102 108 105 91 91 106 114 110 105 97 98 101 86 95 115 98 89 105 98 111 
0 108 96 99 91 85 97 97 98 108 108 99 107 112 100 113 93 112 108 109 99 97 106 104 90 97 108 102 98 103 110 103 114 107 102 104 98 94 92 105 103 99 99 105 105 99 91 103 93 98 112 90 84 94 98 113 99 112 98 100 106 106 108 107 105 
0 104 104 100 103 98 99 93 95 112 109 113 104 97 104 89 104 85 112 117 112 107 102 100 98 93 88 103 98 101 99 105 110 89 113 104 95 102 94 98 107 103 103 97 100 108 112 99 99 97 91 107 111 107 106 104 108 95 100 96 108 94 97 98 111 
0 98 90 107 98 101 107 87 101 98 86 103 88 103 104 102 100 88 99 88 96 99 96 90 111 100 104 87 87 93 103 92 101 112 111 104 112 101 95 104 106 108 95 112 95 98 114 111 91 102 105 101 112 109 90 96 111 100 109 104 98 103 95 92 98 
0 75 90 96 91 85 98 98 98 99 107 102 82 105 101 98 110 98 102 103 111 111 106 105 102 93 102 97 105 102 105 97 95 101 117 91 103 97 103 97 110 94 102 115 104 97 99 102 109 89 101 94 92 102 107 106 85 97 100 106 93 95 100 92 93 
0 97 91 101 86 99 91 101 101 106 99 102 95 104 105 97 94 98 112 110 107 100 119 112 97 94 99 104 97 103 107 93 107 100 106 103 95 89 108 93 105 102 93 92 103 110 101 99 109 109 96 97 93 107 102 101 107 98 102 105 102 99 98 95 108 
0 105 91 88 90 105 94 90 88 91 97 101 95 102 102 96 101 88 107 103 105 120 103 108 96 106 87 96 106 110 104 115 103 98 95 93 97 112 98 111 101 94 96 99 109 111 110 104 101 100 103 105 108 111 91 108 93 94 104 102 105 106 111 106 102 
0 89 105 100 102 104 115 93 93 97 111 109 101 105 106 94 101 100 109 107 107 111 81 102 99 95 117 112 109 102 103 104 103 100 98 100 114 102 95 101 100 106 105 103 102 93 91 87 92 109 104 110 108 102 101 110 103 94 110 92 99 93 88 104 108 
0 96 98 90 83 94 100 95 96 110 107 98 98 102 102 103 100 93 101 103 91 99 112 113 91 105 103 95 102 98 108 109 106 95 102 108 101 99 107 92 103 90 93 101 101 100 102 104 97 89 96 116 102 100 99 93 95 97 107 113 112 103 98 96 103 
0 95 100 120 104 95 101 98 94 91 102 103 92 115 111 96 106 94 107 115 117 101 108 90 97 123 100 106 96 105 109 100 93 98 98 90 103 108 112 100 106 94 101 94 113 111 103 109 89 91 100 105 104 101 105 99 107 111 102 111 94 92 107 89 103 
0 103 106 102 102 95 96 94 103 106 98 105 97 103 103 92 95 103 102 98 103 95 108 105 103 106 104 112 120 98 98 101 101 100 91 97 97 97 96 93 108 103 90 109 107 106 103 90 114 101 101 104 113 108 112 100 109 104 111 116 102 97 97 105 104 
0 94 89 89 98 110 100 97 93 105 100 92 92 106 94 92 99 102 105 106 103 93 103 103 96 110 102 105 118 106 105 94 88 107 119 103 104 94 111 100 104 100 110 94 107 98 102 106 106 95 90 102 94 100 97 113 105 105 91 99 95 97 100 99 109 
