377 45 56 40 88 62 55 78 70 56 67 51 69 80 62 64 53 
411 48 68 48 72 75 45 69 65 68 90 56 48 78 67 61 50 
379 61 65 66 85 62 51 53 67 44 67 62 68 61 79 68 76 
430 57 51 55 75 61 56 73 66 60 75 55 56 74 59 50 49 
443 50 55 63 76 68 67 80 65 64 74 30 62 74 68 61 53 
393 56 54 60 72 66 53 70 65 58 88 54 74 76 78 55 56 
382 59 66 71 81 67 58 64 69 72 81 69 56 78 68 87 60 
416 45 59 52 66 61 44 79 62 57 79 66 52 92 69 67 43 
462 41 41 75 65 54 42 74 65 68 70 57 70 83 58 66 55 
389 39 61 72 94 63 65 64 76 63 76 64 67 65 63 57 57 
423 56 68 65 65 58 69 60 59 63 82 41 49 73 67 64 56 
429 51 61 58 82 51 54 64 64 42 66 50 57 71 54 68 58 
454 58 51 56 74 57 43 91 52 40 75 54 67 68 64 55 63 
454 44 48 69 66 66 48 84 66 56 72 53 47 67 60 64 43 
540 15 60 59 50 60 47 69 43 53 45 53 49 54 64 48 39 
368 45 63 82 77 60 63 76 89 66 82 43 75 66 62 68 51 
421 59 55 61 68 65 39 80 74 59 72 39 65 80 69 55 57 
492 38 44 61 77 54 32 61 52 60 67 38 58 71 65 52 62 
443 56 57 56 72 66 50 86 44 67 68 39 63 68 65 65 51 
434 53 66 72 60 53 60 76 60 71 64 55 62 56 64 71 33 
398 58 74 51 74 67 44 85 80 79 69 41 71 78 73 61 67 
413 49 71 71 65 52 66 79 67 43 83 60 51 75 60 65 42 
407 45 54 72 74 67 36 78 61 46 80 64 66 93 64 74 62 
441 63 59 56 64 58 22 71 54 68 85 60 61 67 59 77 52 
385 53 63 54 90 57 42 80 75 43 85 58 71 80 61 67 54 
445 37 65 57 70 67 50 64 65 48 69 25 56 74 60 50 60 
388 59 50 60 90 57 42 84 69 69 59 50 75 73 60 59 55 
367 64 41 56 88 63 56 71 52 55 73 71 54 87 52 61 61 
382 57 57 70 73 61 68 60 47 68 79 39 76 71 60 67 64 
414 62 63 73 67 56 51 66 65 64 83 59 57 73 49 68 62 
397 47 52 63 69 61 64 77 62 45 89 45 64 88 89 76 65 
453 48 67 68 78 50 47 67 70 59 75 39 63 72 49 52 46 
409 43 75 72 75 59 55 81 64 71 72 60 62 78 57 72 64 
385 53 61 53 83 78 68 75 69 71 78 61 60 74 69 63 63 
454 55 48 45 62 62 47 64 62 57 59 58 53 75 62 56 69 
392 59 47 51 84 58 52 79 61 61 71 46 67 75 66 80 62 
458 39 53 58 65 78 65 70 64 71 78 43 68 73 62 58 51 
387 43 63 74 76 69 49 84 58 56 63 50 66 75 69 58 59 
446 46 63 58 65 67 54 65 58 56 81 70 60 73 63 39 36 
403 53 63 59 61 58 50 62 69 41 76 51 74 77 62 65 33 
