721 18 69 67 74 66 49 68 32 68 74 64 79 67 70 73 64 56 89 60 77 82 68 59 67 76 71 78 88 96 83 48 71 54 74 94 74 77 67 58 62 77 55 62 70 61 73 33 51 55 80 51 63 69 46 47 30 36 70 80 59 74 58 25 3 
298 56 60 65 68 59 64 54 34 78 61 82 61 78 66 48 61 58 66 87 75 84 72 79 71 69 73 73 92 77 74 72 52 69 81 99 95 84 86 79 67 59 59 91 70 72 81 71 59 72 67 50 71 74 51 47 54 58 46 50 66 51 81 10 2 
642 48 69 54 82 43 54 54 28 65 65 65 67 77 64 65 52 56 60 59 80 66 60 45 52 67 52 74 97 98 72 63 64 51 68 74 76 85 72 61 36 65 62 72 76 63 66 65 64 57 75 65 72 64 65 52 37 61 70 62 64 45 39 28 2 
356 59 72 64 64 66 79 66 45 64 63 79 63 58 79 65 45 63 64 77 87 69 70 58 54 74 82 79 84 86 78 73 45 52 73 81 76 99 72 83 45 72 75 67 83 91 68 75 51 45 64 56 74 79 61 47 43 59 63 63 65 59 76 28 3 
377 55 54 60 69 62 61 45 41 61 53 68 77 73 70 58 42 59 58 89 83 86 81 65 72 66 81 83 95 80 90 84 61 59 72 84 108 85 81 69 42 64 69 98 90 85 60 56 62 61 60 77 69 78 67 78 61 53 60 59 54 46 73 11 4 
303 48 58 63 60 69 52 65 28 53 60 73 81 76 69 83 42 47 63 77 95 84 66 62 65 57 86 83 91 93 81 68 71 82 90 102 77 78 79 56 47 72 70 56 99 73 69 60 51 53 73 77 74 75 75 54 65 45 65 72 70 59 55 18 6 
425 57 47 60 86 49 56 50 55 66 72 67 74 87 66 62 69 72 71 64 85 86 87 67 51 62 83 91 83 79 75 66 59 72 77 80 87 99 64 55 59 48 72 62 81 78 61 55 54 62 61 57 71 70 62 61 29 42 56 64 63 64 55 42 5 
287 42 54 63 50 57 60 61 50 64 68 74 73 68 59 60 48 64 69 79 77 79 69 52 62 66 70 81 86 87 90 74 71 51 65 85 83 80 78 70 48 80 84 78 79 72 77 71 76 75 49 80 78 66 59 47 53 63 53 62 48 70 59 14 4 
356 53 76 68 59 53 68 64 56 66 70 66 64 73 59 72 55 67 81 77 79 84 66 53 65 71 79 92 78 85 102 79 77 61 72 91 89 86 81 53 51 67 76 84 73 83 80 54 60 65 61 66 71 75 63 59 46 50 72 73 77 68 57 39 3 
597 51 54 51 56 57 68 57 30 47 78 57 62 70 58 45 68 64 72 76 81 58 73 75 50 64 84 87 75 70 80 65 51 57 78 86 76 79 73 63 44 54 72 80 79 75 67 40 51 56 55 63 66 67 69 48 46 56 67 53 61 62 63 22 3 
466 41 62 60 57 78 55 59 62 71 65 85 79 73 58 80 31 68 67 81 79 78 70 65 49 54 61 80 97 90 72 65 61 68 72 85 78 77 70 64 49 67 75 80 93 83 62 59 72 53 76 87 74 73 80 66 34 53 57 64 56 60 66 17 6 
324 62 65 84 68 74 60 63 61 84 76 68 62 79 68 53 57 57 82 68 87 83 76 65 58 63 66 87 86 85 74 71 56 64 79 95 88 87 81 66 62 61 67 82 81 86 75 57 81 59 74 73 68 85 63 70 46 63 54 61 64 67 52 29 0 
293 62 56 59 59 61 81 58 28 61 70 83 92 55 76 65 63 67 48 76 81 79 81 80 62 62 94 95 75 101 82 63 50 66 66 80 97 92 79 74 55 64 72 81 76 78 70 63 48 60 47 61 71 75 49 62 41 86 58 59 79 57 66 36 0 
510 59 67 58 68 76 67 45 33 55 55 66 69 71 63 50 59 81 64 67 85 72 64 66 41 75 74 91 99 75 81 67 59 61 80 82 80 95 84 69 50 65 88 66 86 74 74 55 70 58 67 71 70 69 45 55 58 58 53 62 72 63 76 30 2 
365 44 50 70 74 65 89 54 43 70 70 69 62 63 67 54 54 70 85 79 78 84 90 61 58 65 80 91 83 86 87 91 73 65 70 80 88 89 85 71 48 79 73 63 85 79 80 59 52 62 83 52 73 66 73 36 45 58 70 67 72 65 62 23 2 
638 37 68 61 58 69 52 59 38 64 48 77 70 71 61 42 60 74 71 81 78 82 65 77 57 63 74 80 95 79 74 54 66 52 84 76 86 76 65 67 43 63 62 62 69 92 50 50 41 48 65 59 64 61 35 34 36 39 81 63 63 66 73 32 5 
490 42 59 55 57 69 59 59 59 58 54 67 77 74 61 67 40 90 72 74 83 87 79 66 37 63 57 88 89 84 75 64 46 59 75 87 93 81 72 64 48 64 67 74 81 91 80 62 46 66 66 56 71 63 73 55 50 53 65 59 66 63 62 21 5 
475 37 69 62 63 58 62 64 38 64 66 74 75 71 77 53 48 59 67 80 72 89 72 61 44 71 78 90 86 82 81 71 52 65 81 95 84 78 69 58 37 51 82 76 96 80 66 65 57 57 66 66 63 68 46 38 52 52 65 64 61 63 61 36 3 
426 51 53 62 62 59 62 51 27 49 73 67 79 76 60 64 47 66 79 74 87 90 64 86 57 65 73 78 85 82 85 75 50 65 82 79 94 81 77 58 43 66 68 57 86 88 77 60 50 61 64 62 78 79 61 56 41 65 45 58 52 64 66 22 0 
347 36 47 59 67 44 73 60 24 50 72 67 69 67 53 75 58 64 71 79 86 76 89 73 67 64 81 75 94 92 75 64 39 74 74 74 84 83 79 68 57 65 67 72 81 87 74 68 55 46 70 76 76 73 60 63 12 62 61 71 68 65 64 10 6 
606 60 50 64 64 52 54 51 38 55 70 57 67 58 52 60 61 80 68 76 71 81 72 62 41 71 76 70 80 83 85 79 64 59 79 78 84 80 84 50 69 50 63 80 80 82 70 58 63 73 78 75 65 67 67 57 40 50 54 90 67 60 54 42 0 
309 48 44 67 81 68 41 58 34 68 72 73 70 64 70 64 66 69 84 86 89 93 78 44 46 52 81 91 93 85 88 56 68 57 62 73 89 77 86 61 66 66 69 78 83 77 70 50 73 68 61 70 65 67 62 60 36 60 68 57 60 54 67 31 3 
405 61 63 51 67 71 54 62 47 50 60 66 85 63 78 61 45 66 76 83 86 83 69 60 57 58 80 90 84 83 82 75 63 43 78 80 88 81 65 67 40 63 79 64 77 78 74 64 39 64 75 60 52 70 57 44 36 50 55 64 75 67 49 22 5 
342 48 61 76 68 71 53 50 53 62 55 70 75 85 56 73 31 64 93 71 83 84 71 63 59 50 72 80 89 94 71 60 47 68 76 91 93 89 84 71 64 72 67 76 87 77 69 61 36 69 70 76 75 61 66 70 27 66 63 65 60 73 61 30 6 
373 41 68 77 71 63 73 65 41 53 60 61 60 70 73 78 46 60 62 86 77 75 67 58 65 83 69 85 90 85 86 70 61 90 74 90 87 91 88 61 37 50 68 65 94 83 69 59 60 53 67 71 79 54 77 72 45 65 68 54 63 69 56 27 1 
352 36 64 65 89 58 60 59 77 62 65 89 70 70 81 67 49 58 75 69 88 95 67 63 40 79 67 84 91 99 86 64 66 77 70 79 80 87 80 64 52 46 75 72 92 70 62 64 62 57 69 62 75 78 71 56 66 53 71 70 74 65 58 32 0 
370 65 66 65 67 58 58 55 52 57 45 60 76 75 85 76 49 70 62 64 83 77 76 64 57 66 70 77 82 93 88 67 55 72 89 90 91 86 87 71 56 71 70 79 81 87 67 61 56 54 69 70 68 75 66 52 57 46 58 67 75 68 44 26 5 
473 59 56 75 81 78 79 61 53 56 55 57 68 55 63 53 57 73 79 65 92 88 82 73 43 77 65 81 94 86 57 68 49 68 66 81 83 48 88 80 42 72 59 86 76 78 74 62 45 52 56 74 75 72 69 49 32 40 58 66 69 54 65 34 0 
395 54 53 77 75 68 70 63 43 57 74 72 69 70 78 57 51 54 71 72 88 85 72 72 54 56 79 85 81 80 90 73 70 62 80 97 85 88 80 63 47 58 93 83 78 81 63 56 54 55 60 66 80 67 63 58 42 62 53 70 73 59 72 14 5 
527 53 69 72 70 42 66 60 52 49 58 63 73 64 66 83 36 76 89 84 85 80 58 64 30 59 71 82 90 88 84 76 76 69 63 84 75 76 70 71 49 60 81 60 74 69 75 42 41 65 48 66 61 67 64 55 70 43 57 69 46 73 67 3 2 
388 62 67 80 61 72 80 56 49 63 45 64 80 68 75 72 65 74 63 96 80 90 79 80 53 70 88 82 94 85 81 65 73 73 67 73 93 78 79 79 44 68 75 72 81 81 60 39 69 70 65 61 62 78 52 50 57 52 69 69 52 53 42 26 3 
340 76 58 63 47 74 67 67 37 67 61 64 71 47 64 61 50 61 67 69 85 81 69 75 55 58 84 83 86 82 77 64 62 76 83 84 89 97 84 65 68 79 75 79 84 79 66 65 56 59 75 71 59 75 60 54 53 37 69 66 72 76 54 50 5 
470 53 59 69 61 55 56 46 39 70 54 70 72 66 100 59 63 67 69 79 83 79 63 58 68 71 81 89 80 74 77 58 69 61 68 88 85 78 74 76 44 67 73 76 83 80 69 47 57 72 67 60 71 65 54 56 47 52 68 71 75 56 63 34 5 
311 44 55 66 90 78 57 58 55 65 57 66 63 79 65 71 52 68 71 77 84 86 73 65 73 66 62 72 95 87 71 64 67 55 78 79 98 82 71 66 59 65 88 76 79 77 61 52 47 47 65 76 69 72 78 46 51 55 80 70 68 53 67 39 2 
368 55 71 69 73 72 64 42 47 53 78 73 62 69 82 58 61 62 69 85 74 73 72 81 41 65 74 88 85 75 88 79 61 61 64 75 76 83 67 69 59 59 69 81 64 77 71 59 54 40 67 69 64 60 62 56 39 63 71 62 61 55 67 5 0 
326 41 48 69 66 71 65 55 42 55 51 71 75 90 60 69 87 69 80 80 95 84 87 55 77 69 81 88 92 94 64 68 58 55 70 75 93 80 68 55 73 64 73 72 83 79 76 55 58 57 79 59 85 58 56 56 66 63 66 57 61 71 71 29 0 
410 56 60 60 53 70 65 59 50 71 63 64 76 72 67 75 52 71 74 92 76 74 84 71 67 61 65 86 85 92 84 53 51 63 76 85 88 82 84 76 48 72 60 65 76 82 77 78 60 49 57 69 63 85 44 46 46 52 55 66 54 59 59 33 1 
463 46 60 58 53 65 67 53 47 50 71 66 74 59 70 41 41 51 70 70 87 86 74 65 60 61 89 87 92 93 86 70 47 74 82 78 77 96 81 62 34 70 60 83 78 83 78 63 28 70 61 54 57 61 63 70 43 42 67 68 68 53 55 17 2 
413 41 60 77 46 60 66 71 19 66 51 83 79 89 72 77 50 54 69 79 100 96 64 77 37 66 74 73 92 84 81 60 55 54 90 78 79 83 71 66 61 74 57 66 81 85 67 64 52 50 77 85 67 63 52 45 45 40 69 65 58 62 63 12 3 
363 50 59 51 68 48 71 55 71 56 74 58 65 79 56 37 73 68 70 84 85 81 69 81 59 61 88 91 88 89 77 68 65 56 83 93 97 91 79 75 69 71 66 61 83 90 64 59 51 62 65 68 74 80 65 57 46 33 55 76 55 61 68 32 5 
