0 90 101 111 122 103 108 103 124 105 108 112 111 93 124 113 111 
0 102 103 112 113 101 118 125 109 122 134 105 111 102 105 111 110 
0 105 117 119 103 97 120 122 115 126 121 121 108 98 122 120 110 
0 114 98 116 105 109 99 125 105 100 119 121 112 103 118 118 126 
0 109 115 116 113 103 115 107 97 107 122 124 100 109 99 105 103 
0 100 107 92 96 99 118 121 120 107 131 117 98 104 136 114 132 
0 93 103 104 98 92 117 103 103 119 116 113 103 105 124 128 115 
0 96 100 106 92 111 121 121 124 103 116 116 122 110 112 111 109 
0 93 93 92 91 101 110 118 99 98 115 119 115 102 113 125 108 
0 100 103 104 115 101 107 108 116 112 118 116 131 108 110 123 109 
0 103 99 110 103 102 112 133 97 100 108 129 113 106 94 114 110 
0 86 92 108 95 102 107 112 103 106 118 115 112 98 121 129 119 
0 113 100 111 117 103 121 119 115 114 117 115 121 110 129 116 105 
0 99 116 99 101 110 118 107 106 105 127 122 102 104 124 111 115 
0 96 105 98 107 106 115 113 118 96 114 103 110 99 113 116 112 
0 87 97 107 112 113 119 106 113 107 119 114 128 114 115 115 109 
0 92 108 113 101 111 114 105 116 111 118 115 101 96 119 119 116 
0 98 105 112 95 113 109 116 106 109 108 114 109 113 108 120 110 
0 104 99 98 97 110 108 115 96 116 114 112 98 113 123 131 99 
0 113 103 110 109 103 125 119 110 100 124 136 120 103 119 114 124 
0 101 103 94 96 103 113 119 108 112 111 123 123 117 115 124 114 
0 95 98 112 109 102 115 116 118 105 122 116 104 100 110 102 111 
0 92 110 108 124 103 100 104 104 113 126 108 134 95 110 126 121 
0 91 108 96 115 100 122 114 108 115 120 124 115 104 113 115 135 
0 93 93 104 109 91 110 104 126 121 111 111 109 98 123 130 121 
0 114 115 115 110 114 132 110 113 119 129 115 106 103 113 113 116 
0 99 103 105 92 100 105 113 108 103 115 112 107 94 123 111 113 
0 96 100 96 109 114 114 109 112 114 122 110 114 121 105 121 112 
0 92 107 111 111 97 115 117 117 105 114 122 104 107 123 111 109 
0 99 117 100 117 106 108 126 113 104 125 127 111 111 126 112 117 
0 96 99 105 88 105 108 113 104 114 118 114 107 109 124 134 125 
0 99 114 105 90 109 110 105 122 113 126 109 112 113 113 112 110 
0 108 102 112 102 102 116 106 111 107 108 116 112 113 104 107 120 
0 89 109 110 112 105 109 117 129 104 121 118 116 108 110 115 114 
0 110 108 105 105 98 107 108 116 103 109 114 121 105 121 100 113 
0 101 103 107 104 111 106 133 114 107 125 118 109 97 114 104 117 
0 96 95 105 112 104 116 110 126 102 114 114 99 111 114 116 114 
0 108 99 98 105 91 103 111 120 115 105 120 122 110 114 126 112 
0 91 112 103 110 116 115 124 118 101 120 127 117 109 124 107 113 
0 90 100 111 98 101 120 111 121 109 131 107 107 90 107 103 108 
