298 52 40 67 68 53 71 65 41 63 84 64 64 90 77 66 42 66 71 66 72 75 84 74 70 59 89 101 95 81 92 64 62 76 78 89 75 89 78 67 66 66 78 63 91 78 70 59 50 48 66 85 65 77 61 64 55 47 64 73 86 68 46 33 1 
369 42 66 65 66 57 70 45 54 52 50 83 78 79 79 64 57 62 77 80 77 87 72 70 53 66 96 87 88 89 96 72 70 55 86 81 91 67 76 66 58 66 74 79 92 74 72 55 60 55 63 73 80 62 74 57 52 53 60 62 75 60 60 25 0 
416 55 59 60 66 65 69 50 37 58 51 74 76 79 71 63 55 75 67 71 87 68 72 56 44 63 68 84 91 86 70 58 52 60 68 79 92 71 72 67 67 59 79 105 58 84 77 55 66 54 67 62 67 59 63 56 48 70 58 74 52 68 59 19 2 
327 42 65 79 59 75 71 62 56 70 44 68 77 76 74 80 55 65 69 76 91 81 65 59 66 63 59 82 89 89 76 70 61 56 82 73 94 82 69 65 60 83 71 87 70 83 68 47 46 69 69 61 69 86 73 44 53 69 69 68 73 57 76 55 4 
568 51 56 68 62 61 72 56 60 62 59 67 67 70 30 52 43 66 73 70 75 85 68 66 62 59 85 77 77 83 93 70 44 71 74 80 76 82 70 66 38 71 64 78 72 79 68 44 55 54 73 77 70 59 68 70 48 57 64 66 64 62 61 7 6 
298 71 74 77 62 69 50 67 52 55 62 63 71 94 48 55 74 58 86 97 88 94 67 74 57 67 73 94 96 86 80 61 61 68 74 80 87 89 80 71 66 72 82 82 94 83 56 72 54 60 68 69 82 60 69 63 55 44 57 69 71 76 58 37 2 
589 41 46 73 56 67 56 55 51 61 68 77 72 75 67 46 52 56 84 74 77 78 58 72 56 67 66 79 75 79 87 64 65 77 78 81 80 82 82 74 39 36 70 82 78 70 58 63 68 43 71 59 60 71 48 66 40 60 64 70 55 63 60 39 1 
501 63 69 64 53 62 48 44 33 71 63 68 73 87 58 55 58 71 81 78 82 91 57 44 47 61 72 86 90 94 78 60 52 69 63 75 91 77 69 51 64 67 64 70 85 82 62 55 52 55 64 66 95 78 62 54 58 51 83 71 79 60 51 13 3 
360 60 65 53 70 64 51 52 39 58 70 70 78 61 78 69 49 61 71 70 89 91 66 52 51 61 79 83 79 85 89 57 62 62 80 79 95 80 77 71 56 73 69 92 75 79 75 65 67 54 71 71 75 80 50 57 62 59 55 55 75 58 71 24 0 
353 58 51 59 66 48 62 41 42 51 69 59 74 60 66 53 45 51 79 75 80 83 68 60 70 61 76 90 90 91 73 70 70 56 76 87 96 89 68 69 69 71 77 71 77 86 67 64 50 63 59 72 78 76 62 63 32 61 65 72 73 68 68 20 6 
257 74 67 74 56 70 75 52 78 59 60 80 82 68 71 70 61 73 70 77 90 69 75 59 55 62 77 77 91 82 87 74 58 62 78 78 84 77 60 75 56 67 91 76 78 72 74 50 50 54 65 82 69 65 57 61 61 50 69 58 60 62 60 10 4 
585 48 64 61 58 58 70 61 51 53 58 65 68 73 65 63 46 76 81 70 70 76 66 47 48 53 63 76 81 88 81 48 52 73 56 72 79 86 68 58 44 60 84 69 69 90 68 53 74 56 61 69 76 64 63 49 63 58 64 80 45 71 73 26 5 
404 51 60 62 72 55 60 52 44 57 42 71 60 70 72 64 47 55 70 93 81 90 57 69 58 71 85 92 99 105 81 78 49 71 79 95 83 71 82 68 64 69 66 80 82 90 65 44 59 71 66 77 82 87 66 43 25 46 69 63 58 67 77 28 5 
312 55 47 71 63 79 53 52 63 59 72 79 81 71 70 73 39 65 68 78 82 85 68 69 54 64 83 103 88 68 71 58 62 60 81 86 98 82 80 53 68 60 89 69 82 79 72 53 58 58 64 75 67 77 65 54 49 58 70 67 76 59 64 28 0 
372 43 67 63 78 60 53 70 49 45 82 74 71 70 83 68 46 73 68 68 74 80 58 64 55 67 82 81 84 76 76 65 72 52 63 84 94 90 69 68 39 63 59 73 78 85 61 77 42 41 66 77 82 64 55 44 35 48 79 74 69 69 55 25 0 
441 58 50 71 57 61 68 61 28 63 66 75 76 74 70 70 56 62 80 74 84 77 74 65 67 61 76 87 84 87 77 71 63 79 66 80 94 91 82 70 45 76 90 72 77 81 61 62 55 53 75 59 75 53 58 56 40 53 52 65 59 56 53 41 1 
396 68 54 64 62 60 75 63 34 62 56 79 72 63 70 59 39 55 78 69 89 90 73 65 47 75 70 83 94 82 84 82 51 56 70 87 88 82 70 71 73 64 72 72 87 83 72 53 45 63 55 70 73 59 76 51 42 50 58 63 67 60 64 12 0 
308 36 48 54 72 51 60 72 41 53 69 64 79 79 65 62 62 54 64 83 79 90 72 67 62 64 77 82 99 99 79 63 60 72 70 68 79 81 68 78 48 68 56 69 81 89 84 59 60 57 56 65 80 56 59 65 44 53 83 65 59 78 67 23 2 
243 55 71 68 74 73 62 67 38 53 57 67 77 80 73 87 52 68 72 83 76 93 88 76 72 74 78 76 85 78 70 77 41 64 91 87 102 84 74 62 78 55 55 77 91 87 69 62 54 49 69 63 86 73 59 48 48 67 58 69 65 60 63 5 1 
299 48 67 58 70 61 73 60 51 60 71 65 68 85 78 76 58 64 70 80 78 83 79 65 55 68 76 76 103 75 86 80 49 77 75 80 85 72 83 65 38 82 83 78 65 76 71 63 53 48 49 92 73 66 71 64 61 60 72 74 88 83 72 39 5 
294 58 70 70 67 71 54 62 46 47 77 97 84 84 78 68 63 70 86 75 92 82 73 64 66 70 72 92 91 92 77 61 51 68 83 88 103 80 71 73 52 56 69 83 78 81 80 49 58 62 60 71 64 66 44 62 56 42 64 66 59 73 69 38 3 
562 67 52 75 61 72 68 52 58 55 65 60 81 59 54 82 43 63 77 70 86 82 71 92 51 71 61 78 87 94 80 81 35 81 75 90 89 83 77 59 33 74 68 82 88 84 73 44 65 37 58 67 77 72 58 71 58 69 65 67 74 72 55 13 6 
637 60 50 61 48 58 58 59 39 68 41 79 59 64 59 56 57 53 82 78 75 76 86 53 47 53 80 79 81 81 77 78 49 51 76 85 93 81 73 64 31 68 69 60 78 64 63 56 39 55 86 51 64 82 63 52 39 47 41 58 64 46 68 40 2 
492 42 57 64 61 53 62 50 41 66 67 80 76 71 60 72 59 57 76 77 77 81 62 84 69 67 78 84 77 89 73 67 58 63 61 70 73 83 81 74 49 72 78 74 84 85 63 55 64 68 78 69 87 68 50 62 35 48 54 58 52 59 59 31 6 
377 66 69 57 55 66 79 43 46 63 74 71 71 72 69 50 52 71 87 75 81 81 61 74 52 69 68 80 80 87 76 71 54 65 85 98 97 78 78 58 61 66 50 93 76 82 56 53 63 75 77 76 73 73 62 50 36 53 68 65 69 59 72 27 4 
314 47 64 70 62 61 69 58 59 57 79 73 79 77 72 71 50 76 67 85 87 86 78 60 44 67 82 80 99 86 77 67 59 62 83 70 95 88 73 81 57 67 74 76 91 83 64 60 57 57 68 58 81 67 63 66 53 56 57 69 77 42 77 25 1 
376 40 47 74 62 68 65 64 54 62 60 78 69 83 56 54 56 61 69 82 88 98 64 65 56 80 64 79 83 93 81 70 62 65 85 79 92 104 81 70 56 54 83 78 79 77 72 52 56 52 68 66 65 66 64 50 51 53 67 74 52 68 57 25 6 
396 39 62 61 67 73 56 65 64 51 64 66 67 83 76 41 61 66 65 82 80 78 75 50 69 77 73 76 88 84 86 65 57 65 73 77 106 84 83 73 66 62 83 75 76 83 72 55 54 50 47 85 68 68 51 44 49 50 69 85 74 66 63 18 3 
354 44 55 66 60 68 71 56 50 62 68 74 88 78 57 52 59 65 70 81 91 89 94 81 60 71 80 78 88 104 100 68 41 62 68 88 76 86 70 70 68 74 63 71 83 73 65 71 53 59 54 65 70 70 67 57 45 74 56 67 70 53 72 18 1 
352 54 55 53 77 60 59 43 70 84 52 64 68 76 61 54 51 79 72 64 87 81 64 85 51 66 73 82 79 86 80 62 63 46 77 94 84 68 75 61 64 60 72 68 75 75 71 66 67 47 61 73 70 70 73 51 69 47 72 77 62 63 62 49 1 
435 36 57 76 57 61 55 58 44 47 66 82 67 67 62 59 45 64 60 69 74 78 95 77 50 56 87 82 81 91 75 71 51 48 66 85 90 89 82 49 54 72 68 72 76 80 48 56 65 43 78 73 65 69 57 51 57 49 57 74 59 56 73 25 2 
371 45 52 62 62 81 69 54 32 57 69 67 84 79 63 81 51 52 76 89 78 91 58 65 65 78 71 86 77 95 76 59 71 65 71 89 90 91 76 46 67 73 68 73 82 80 58 68 54 72 68 67 79 68 54 58 60 48 54 63 60 61 67 51 3 
332 58 62 61 63 73 66 58 36 46 73 92 70 70 66 71 46 44 81 83 83 81 78 51 54 81 70 79 86 80 65 78 55 62 80 86 89 86 86 62 64 71 63 75 91 103 58 58 52 69 71 77 75 74 68 49 50 54 53 71 58 54 59 27 1 
271 50 56 67 71 74 44 37 51 59 33 82 83 85 62 82 47 67 77 83 108 83 99 65 62 61 81 80 103 95 87 64 63 79 63 69 85 87 80 69 63 67 67 81 75 79 83 78 58 61 69 67 68 69 65 43 42 56 68 78 46 70 58 32 1 
651 55 53 66 57 52 54 58 44 62 45 54 60 73 64 52 30 63 64 75 76 66 59 58 66 79 71 81 79 90 82 59 46 62 65 80 78 93 69 50 60 59 79 65 71 71 66 63 74 85 53 65 61 74 46 43 52 71 67 74 46 57 61 35 5 
319 59 65 64 74 48 70 61 56 76 51 46 64 77 72 67 41 71 70 63 89 87 81 71 65 69 70 87 91 90 76 81 36 74 71 88 84 80 77 83 40 61 69 88 86 81 61 53 41 56 72 68 61 69 68 66 46 44 60 91 62 45 68 43 1 
447 56 71 55 72 76 51 70 52 58 68 69 76 75 68 52 40 73 60 106 102 71 86 64 43 68 76 86 87 90 75 71 55 74 58 87 97 79 81 60 66 85 63 73 78 80 68 45 50 70 64 64 77 71 64 41 54 60 64 62 73 64 65 30 6 
570 42 53 56 62 68 72 55 48 63 64 75 78 52 71 52 73 55 72 86 83 92 78 61 62 64 82 79 76 90 78 75 49 66 71 83 80 87 77 67 69 70 67 77 75 78 58 57 55 72 57 63 71 56 69 49 41 57 60 56 71 46 62 26 1 
408 56 56 68 68 75 68 58 61 56 66 74 70 69 58 54 41 59 54 72 90 70 62 62 48 55 76 92 87 85 71 66 62 76 77 88 87 86 63 58 64 63 61 82 72 82 82 59 62 67 57 65 82 69 69 52 68 53 61 68 58 59 60 36 6 
444 60 50 46 60 68 77 57 37 65 65 85 81 69 72 67 41 67 73 61 90 79 84 82 45 72 74 79 87 82 75 55 75 66 71 72 79 80 66 56 52 68 76 80 68 91 69 52 59 51 71 76 70 78 57 47 56 50 55 59 70 60 80 33 0 
522 58 64 69 56 65 74 72 45 56 56 58 56 72 56 65 35 70 71 80 87 76 80 65 48 59 75 89 68 83 71 69 47 72 61 88 89 89 74 65 58 67 53 59 91 81 59 52 46 56 61 56 75 61 45 43 49 57 72 72 61 69 57 25 2 
665 35 54 56 64 74 79 52 33 57 70 51 64 63 69 55 44 62 55 54 99 83 58 53 70 74 55 76 87 79 88 63 37 79 45 77 81 82 89 72 61 63 54 44 88 82 80 50 61 65 54 72 63 71 47 36 46 62 65 63 62 59 63 14 6 
454 50 69 51 66 80 66 52 44 72 83 83 78 64 76 62 49 65 69 65 80 69 67 61 61 65 70 90 90 93 77 73 47 69 65 73 95 94 77 54 63 70 63 72 84 89 65 56 53 58 67 54 76 69 68 46 48 51 66 73 73 67 74 19 3 
397 45 74 55 70 60 55 46 58 55 56 67 64 61 73 68 32 61 90 74 79 106 65 68 65 76 78 97 91 102 86 63 58 59 85 83 77 76 80 57 54 76 77 67 81 76 65 52 53 67 80 76 69 75 64 50 59 55 67 53 75 58 68 40 5 
650 47 61 49 51 44 61 47 47 56 61 54 68 65 58 70 60 70 76 65 85 84 79 67 60 53 79 75 78 80 82 73 64 67 73 71 93 82 76 78 45 60 66 77 83 79 66 60 47 60 66 79 68 71 70 42 55 38 55 76 49 67 58 10 3 
370 63 78 71 66 64 70 54 52 57 67 84 82 81 65 59 70 69 75 103 82 83 71 57 47 65 80 83 90 96 77 68 65 50 69 77 76 81 83 65 65 71 90 81 77 72 74 62 50 57 70 72 77 74 58 40 51 51 61 67 83 74 67 31 1 
545 54 48 50 50 54 58 66 14 69 62 62 60 78 63 0 79 68 71 77 67 75 55 62 54 69 78 81 70 83 82 65 50 66 69 65 76 98 72 75 60 50 75 66 78 86 68 57 61 59 66 75 59 76 52 56 51 54 49 67 61 53 53 44 6 
434 59 75 68 47 57 79 51 34 57 70 74 79 60 73 74 65 73 66 76 78 77 65 72 57 57 75 80 80 76 86 66 65 58 64 81 81 78 82 69 51 67 65 69 83 66 69 41 51 55 75 61 63 58 50 56 64 65 56 72 76 55 71 32 2 
370 51 59 62 63 64 63 35 44 71 62 69 68 85 60 56 41 58 71 83 78 95 74 51 64 56 66 89 105 90 82 74 73 71 71 76 91 85 71 54 58 65 49 78 69 80 76 55 60 68 73 74 67 76 57 44 39 46 62 85 79 61 59 22 1 
389 45 59 57 62 67 47 53 34 38 71 81 76 84 69 66 46 60 84 57 89 94 72 84 69 80 85 80 82 82 71 75 65 58 62 78 78 88 85 68 58 76 63 68 82 75 55 52 50 64 58 89 83 67 70 64 46 69 70 66 61 65 55 28 6 
384 64 36 56 59 54 53 40 46 74 69 58 79 74 68 48 65 59 67 59 91 94 65 64 73 78 68 76 73 98 89 77 48 59 77 78 81 90 82 78 63 53 60 62 78 95 79 64 64 66 68 73 63 63 61 60 54 76 62 69 56 56 58 23 4 
256 45 52 65 68 84 63 52 63 37 64 78 72 72 78 69 75 70 59 77 83 81 82 75 66 57 78 100 93 93 80 72 62 74 65 94 80 92 81 71 70 72 71 69 91 81 77 76 66 64 71 71 82 73 49 54 50 56 68 64 72 60 66 9 6 
383 61 61 57 70 55 74 60 54 57 68 61 75 86 80 73 57 49 68 81 82 83 72 67 55 63 66 90 89 82 67 53 54 81 99 90 101 74 85 62 52 62 62 57 85 86 68 60 59 62 56 76 88 77 59 69 38 40 53 65 66 74 63 32 3 
407 52 55 69 80 60 60 48 59 55 57 69 77 72 73 81 74 58 80 80 77 79 74 74 58 71 87 88 85 80 79 59 58 73 75 72 84 81 69 67 58 67 64 72 85 78 62 67 56 55 61 59 66 73 54 60 64 49 67 72 68 60 70 6 1 
563 53 57 74 67 67 49 54 33 55 80 69 67 79 67 57 44 71 57 71 80 81 85 57 56 70 80 80 72 92 76 64 48 71 76 82 85 92 80 63 44 69 78 79 84 89 70 51 35 50 67 63 77 70 71 56 50 49 44 70 71 66 61 28 0 
295 49 49 50 74 77 71 67 40 60 61 70 77 84 75 34 52 52 64 92 91 82 89 59 54 64 77 89 81 84 87 66 69 62 71 89 89 83 87 84 49 88 73 87 80 61 81 55 47 69 57 90 67 72 64 59 59 55 54 72 60 65 56 30 0 
344 63 58 70 82 71 63 68 60 72 72 72 78 65 70 68 70 62 84 73 83 87 68 77 61 64 85 90 88 92 82 62 55 70 74 92 82 97 83 54 52 66 87 86 83 78 68 50 53 42 46 66 84 70 69 57 34 60 67 69 60 50 68 17 1 
373 67 63 61 59 47 69 43 43 61 34 60 80 62 79 55 78 66 57 79 87 72 72 72 66 63 89 80 77 88 76 80 54 77 70 89 89 84 82 66 48 57 78 76 88 81 64 55 62 56 72 73 74 59 57 55 61 37 71 53 68 71 57 44 2 
278 50 43 58 56 80 66 64 67 64 67 77 83 81 70 73 66 62 82 84 87 88 84 70 61 60 75 85 97 88 66 84 65 59 69 79 90 90 71 52 69 65 74 73 72 87 76 67 54 59 49 66 58 67 62 49 46 40 74 76 72 68 53 26 5 
389 44 60 58 69 68 74 57 41 58 56 83 74 94 60 63 36 57 79 85 86 76 74 78 55 54 84 74 93 71 96 62 53 63 86 86 84 88 78 71 54 61 81 78 86 86 72 72 53 72 70 62 81 63 71 51 49 58 65 81 74 75 68 25 4 
