1560 69 55 95 62 53 28 34 40 47 49 63 66 67 48 36 83 64 77 53 49 72 78 59 74 47 81 61 89 98 90 65 65 61 64 94 90 52 79 81 86 74 68 87 71 89 67 85 41 61 101 90 94 91 59 74 83 81 102 85 90 78 88 77 34 
1456 84 50 54 42 72 38 46 45 65 66 77 62 73 39 35 67 59 68 57 42 69 106 66 59 59 72 84 88 89 75 69 51 59 64 99 99 81 76 95 43 60 72 99 63 89 87 48 57 79 74 69 80 98 87 58 33 73 82 101 90 86 83 81 63 
1616 62 72 81 56 48 43 47 38 66 62 59 58 48 45 40 60 88 94 59 69 87 75 60 63 69 66 67 65 108 100 63 59 70 65 81 84 82 73 56 65 70 61 86 81 75 69 83 56 82 77 81 77 90 88 86 45 65 88 79 114 96 85 72 28 
1520 61 62 65 60 52 56 47 23 89 58 91 80 61 47 58 60 75 66 69 84 68 73 50 70 72 84 75 85 81 80 90 81 66 69 106 81 89 80 75 56 56 66 94 84 89 81 87 59 71 88 85 101 87 86 54 18 69 89 90 73 83 88 77 5 
1464 74 56 71 59 48 42 19 41 64 61 75 83 56 69 30 59 45 69 83 54 80 97 70 74 64 84 59 72 99 73 70 83 83 78 79 79 69 80 53 88 60 73 82 67 91 68 82 23 69 93 91 81 90 64 74 99 70 80 98 96 91 86 64 49 
1464 91 36 56 55 46 68 43 45 53 78 62 71 53 61 66 49 73 74 65 53 80 86 56 61 59 66 58 96 71 94 74 54 75 80 79 83 77 72 85 82 75 86 73 80 74 74 82 56 90 94 97 78 94 84 70 45 84 89 100 98 88 75 80 13 
1420 63 81 62 60 58 51 26 28 56 66 58 78 73 36 44 66 56 74 51 62 108 73 92 57 74 72 72 81 86 63 84 64 68 79 98 72 79 70 85 70 98 93 96 75 87 102 48 46 66 88 85 88 83 85 77 56 96 86 95 98 84 89 79 48 
1560 66 58 51 55 58 28 50 38 74 65 70 62 54 53 57 61 71 65 77 76 61 89 67 66 72 77 66 75 89 93 97 67 65 55 91 88 77 80 69 34 79 69 93 92 88 64 61 64 79 74 87 93 88 86 71 18 79 105 95 95 102 79 74 38 
1460 63 67 59 47 69 61 56 47 65 49 77 53 51 37 53 79 70 69 95 56 59 64 73 67 73 73 91 59 88 82 68 62 77 70 80 80 83 73 67 61 71 81 85 87 79 70 92 54 80 78 80 82 80 71 66 53 94 76 83 103 84 80 72 36 
1520 74 77 75 62 46 67 48 25 67 66 52 71 43 52 54 77 87 64 64 86 75 88 72 72 70 48 67 103 93 70 58 80 85 79 85 77 77 81 69 49 73 76 92 72 86 88 65 37 74 80 81 100 80 97 64 69 88 87 86 97 88 99 73 5 
1412 85 72 63 60 59 50 44 32 58 71 60 65 58 95 49 53 82 81 62 69 78 71 89 92 83 74 79 100 88 60 65 82 76 72 88 84 101 73 72 64 67 75 76 90 86 75 62 61 82 82 71 90 95 94 58 32 81 84 92 78 90 105 78 5 
1588 55 62 67 46 59 76 35 42 70 84 69 40 61 36 22 46 60 79 64 71 65 94 55 62 69 77 60 72 58 63 70 79 89 80 80 99 87 81 76 71 71 82 94 90 65 97 73 47 78 77 89 92 95 89 66 45 78 86 86 83 92 76 81 15 
1484 69 62 43 38 49 51 51 28 61 66 82 79 47 74 55 62 69 73 68 84 85 77 83 69 91 54 71 91 78 64 86 62 67 66 81 70 74 88 60 56 74 61 77 94 72 67 68 57 64 84 91 73 90 87 74 54 78 94 97 86 81 87 68 51 
1536 78 64 71 61 51 48 26 55 65 56 56 55 46 49 42 65 66 58 82 83 69 99 82 87 66 67 70 94 98 81 74 64 80 79 94 83 70 57 64 77 78 79 76 103 93 81 52 60 86 77 89 91 88 95 72 40 65 99 108 81 81 94 75 6 
1504 44 61 74 46 51 53 47 61 74 73 64 72 67 62 61 52 65 84 66 66 69 81 70 73 63 82 75 85 86 71 64 80 77 100 83 88 74 92 61 61 78 96 99 90 88 97 59 43 63 83 81 68 76 83 61 43 74 87 86 84 102 96 88 30 
1380 57 69 51 59 52 40 36 51 77 70 67 63 69 49 42 72 71 93 103 59 64 56 77 45 78 74 78 71 77 85 63 64 71 75 86 90 75 88 77 69 88 69 100 89 80 72 81 60 68 85 90 110 84 93 77 81 69 87 87 97 81 97 85 28 
1556 58 64 36 69 83 44 45 22 72 52 52 68 54 37 56 79 73 64 59 56 90 91 79 75 86 65 75 75 95 80 73 86 83 73 108 77 97 86 70 44 86 83 88 92 84 69 61 48 77 86 107 76 85 66 80 43 84 79 84 87 71 88 68 28 
1468 71 84 69 61 52 46 56 38 68 59 55 58 75 45 65 61 69 60 69 56 88 74 84 83 75 74 64 94 75 86 83 60 57 66 94 73 70 67 75 67 66 67 75 95 88 66 94 42 65 85 68 94 74 88 64 30 74 89 97 97 97 91 85 58 
1536 71 47 63 58 49 30 47 28 71 72 66 66 57 70 73 78 73 89 53 47 94 68 93 65 69 80 69 76 83 77 87 86 87 67 85 73 79 72 57 58 79 73 94 88 82 63 60 62 84 80 92 89 93 76 88 35 66 80 98 97 94 84 78 9 
1648 59 76 66 51 50 54 52 28 60 67 75 79 53 49 27 72 70 65 62 77 93 67 78 71 60 70 68 71 88 81 59 92 66 75 61 73 57 76 58 44 68 83 91 81 84 93 39 57 71 80 90 83 89 79 72 70 78 101 80 85 82 89 64 38 
1532 55 78 69 67 60 51 46 27 54 58 52 62 48 74 46 79 62 78 68 68 87 71 80 77 71 58 74 82 76 70 61 47 81 83 78 83 82 83 98 40 71 64 86 107 83 75 74 82 79 65 83 99 80 79 72 63 83 77 78 96 82 88 90 21 
1556 55 52 71 44 69 67 42 50 78 58 51 66 61 69 42 51 79 67 83 55 84 77 64 60 62 76 76 75 79 79 53 59 78 76 92 84 80 98 66 52 84 82 82 84 85 78 76 34 77 73 97 104 84 80 75 65 70 72 90 86 84 79 84 38 
1540 68 59 66 55 79 63 43 33 76 62 67 67 79 37 35 62 63 62 67 81 96 73 63 70 77 66 84 62 65 86 61 61 80 95 78 92 72 87 65 64 70 83 76 84 81 80 66 72 72 58 97 88 86 89 53 54 64 89 87 95 92 80 73 15 
1544 52 49 59 68 58 63 45 35 58 80 49 65 55 67 63 106 64 64 62 73 77 67 72 60 68 52 45 87 85 79 77 94 65 77 83 85 91 80 47 72 70 66 87 83 65 80 72 37 77 58 89 78 79 86 99 81 84 97 98 79 74 77 71 4 
1484 42 77 65 48 50 58 77 36 85 76 70 60 44 56 56 83 69 57 65 78 80 56 89 88 47 61 85 90 78 60 99 59 72 70 79 86 72 93 48 78 61 61 92 89 78 87 54 59 69 71 84 89 88 81 52 31 75 78 79 94 86 96 75 60 
1312 71 79 65 72 60 59 34 55 78 76 63 68 64 51 48 69 85 64 62 64 89 72 74 64 83 62 77 96 86 61 87 52 76 82 79 76 102 83 82 35 73 77 79 81 85 95 85 81 77 100 116 91 79 87 87 31 74 100 82 68 65 89 75 23 
1516 50 80 57 74 51 58 37 29 85 69 76 59 68 57 39 59 65 73 61 68 93 87 77 79 73 74 73 84 73 67 69 65 65 71 92 68 79 96 46 65 63 90 88 95 81 73 90 72 69 76 81 85 82 85 62 53 70 89 84 75 76 83 60 21 
1540 65 48 63 59 71 48 54 39 81 59 63 88 64 46 40 64 78 79 71 66 54 73 94 73 76 91 88 76 86 74 58 54 63 76 77 91 97 71 77 77 81 73 79 96 84 68 67 38 84 72 89 83 88 87 70 33 63 83 78 96 98 100 76 35 
1512 74 69 74 56 65 45 47 35 64 57 87 61 52 64 41 58 78 68 81 55 81 97 85 78 61 75 57 92 81 79 103 62 80 97 91 72 75 68 78 62 78 80 72 77 92 75 73 61 68 88 82 102 95 73 82 24 71 87 85 94 91 96 89 23 
1620 53 85 67 73 59 54 42 38 58 83 63 48 64 23 49 63 69 67 71 70 69 91 80 77 83 69 77 60 70 96 61 62 76 55 78 67 71 74 68 40 91 76 88 70 82 92 60 48 74 89 84 99 73 93 58 24 75 85 87 81 93 81 60 9 
1500 72 75 52 68 50 75 46 64 83 72 66 84 54 60 32 60 64 76 65 41 66 78 67 83 70 67 63 77 80 81 86 49 70 65 86 76 82 80 78 52 84 69 89 95 90 84 66 31 63 88 80 86 70 72 72 35 71 100 93 74 85 88 58 52 
1556 54 63 65 59 59 55 36 21 54 61 87 52 60 72 36 76 77 76 53 55 81 57 81 93 66 79 59 77 73 63 76 70 52 87 98 76 86 75 61 75 70 72 86 87 72 85 67 56 90 90 80 90 99 70 60 50 101 89 87 86 87 90 76 24 
1528 55 55 56 52 34 34 46 43 73 81 85 78 70 47 28 67 84 74 95 57 82 73 75 69 73 75 77 77 93 69 53 58 72 77 84 76 84 64 84 44 71 90 89 87 81 74 80 35 76 78 75 87 79 68 66 58 71 81 84 84 96 82 54 46 
1492 61 78 49 53 39 45 34 51 62 75 89 91 67 59 64 55 46 65 61 37 91 75 69 76 72 48 63 79 66 70 65 61 84 66 78 80 80 80 68 58 90 87 92 86 93 95 57 75 73 87 83 92 78 84 88 63 83 95 84 95 89 91 77 28 
1540 83 62 70 63 63 56 50 65 66 55 51 42 47 41 71 74 69 72 61 77 74 74 77 51 80 76 80 78 83 77 65 62 83 80 88 84 86 87 70 57 52 67 102 101 74 97 81 49 82 69 110 92 81 90 54 48 91 94 88 101 102 89 81 19 
1476 61 56 39 51 76 45 57 29 71 98 81 51 68 53 48 73 74 70 57 54 77 73 58 88 75 69 72 84 89 84 84 65 76 60 80 82 84 70 75 67 71 70 85 84 96 68 53 38 76 88 96 97 79 76 59 74 83 85 70 88 88 94 69 33 
1428 58 77 60 53 48 64 71 32 66 79 76 59 67 68 39 56 71 69 79 50 85 73 79 67 71 65 76 75 63 69 90 68 82 72 96 84 72 60 61 41 72 89 77 102 75 67 76 71 73 79 104 96 89 91 77 89 89 90 95 90 91 91 70 1 
1488 54 75 54 85 63 95 45 47 58 58 72 62 61 63 43 91 75 80 68 45 73 83 68 68 56 61 44 72 98 79 59 68 77 80 92 87 83 68 84 88 75 68 72 87 60 62 72 55 73 79 82 84 88 61 73 46 76 91 96 87 81 88 85 62 
1480 76 52 62 50 66 55 56 64 75 60 60 43 43 36 49 80 86 78 64 74 77 70 65 75 67 65 71 86 95 64 66 72 68 75 99 88 80 72 64 60 74 80 85 104 87 89 61 45 75 69 84 87 68 90 89 50 89 94 78 101 92 77 86 24 
1524 79 62 66 55 49 40 34 32 57 65 77 63 45 38 38 52 67 102 73 68 103 73 68 62 73 64 81 88 84 76 94 50 82 61 80 101 84 75 70 54 75 68 85 84 86 83 67 32 87 83 85 66 85 89 64 73 86 85 85 108 92 97 81 23 
