1284 0 1 0 0 1 3 1 0 2 2 1 0 3 2 3 2 
1332 0 1 3 1 2 2 1 1 2 3 0 1 1 1 0 3 
1340 2 3 3 3 2 1 3 0 1 3 2 2 3 1 2 1 
1256 2 0 1 1 0 2 3 0 2 1 2 2 3 0 0 1 
1312 0 0 0 1 0 0 3 1 0 2 4 0 0 1 1 3 
1324 1 3 3 2 2 4 5 1 0 1 3 3 0 3 3 3 
1324 1 1 3 0 2 1 1 3 0 0 1 1 2 3 2 0 
1288 3 2 1 1 1 1 3 1 2 2 1 3 2 1 2 3 
1316 0 1 0 3 1 3 2 1 3 2 3 3 3 0 0 1 
1320 0 3 0 2 0 3 3 1 1 4 1 2 3 2 0 3 
1280 1 2 0 3 0 0 2 1 2 2 3 0 2 3 1 3 
1320 0 0 1 0 2 1 5 1 1 0 3 3 2 2 0 3 
1284 3 1 2 1 2 0 1 3 3 0 3 0 3 2 0 3 
1312 2 3 2 3 3 1 1 1 0 1 2 1 2 2 1 3 
1324 0 2 0 0 3 1 0 0 1 2 2 2 0 2 2 0 
1352 3 0 2 1 2 1 2 2 3 2 3 0 0 2 2 3 
1328 0 1 3 3 3 0 2 3 1 2 1 0 1 3 2 1 
1352 2 3 2 3 1 1 2 0 2 3 4 2 0 3 2 0 
1308 2 1 3 0 2 1 2 3 2 4 2 2 1 0 1 0 
1300 2 1 1 2 0 2 2 0 3 1 2 2 2 0 0 0 
