0 94 104 96 91 99 85 99 108 91 100 102 116 110 100 104 110 
0 98 100 96 98 104 103 110 111 97 101 104 97 105 113 97 99 
0 102 92 93 100 101 100 116 101 94 102 101 101 96 108 103 119 
0 99 88 95 108 112 94 100 98 98 109 107 96 92 120 108 106 
0 113 95 104 107 95 104 116 111 103 102 110 112 96 100 98 97 
0 97 102 102 98 94 103 99 108 101 93 107 108 104 107 111 104 
0 103 104 107 104 114 103 103 92 99 110 104 110 112 99 106 98 
0 103 95 107 98 92 89 101 104 102 106 97 96 113 114 100 112 
0 95 103 107 89 106 89 98 88 96 115 102 107 102 105 100 105 
0 108 105 87 111 112 104 111 106 101 105 112 100 106 104 103 108 
0 112 103 113 95 87 115 108 104 96 104 109 92 103 103 110 97 
0 109 101 91 102 87 101 99 108 98 102 92 95 93 117 115 120 
0 104 95 102 105 114 102 99 116 99 100 111 103 99 105 106 100 
0 104 99 108 102 94 114 107 105 90 107 111 100 94 104 115 123 
0 92 99 96 96 105 105 119 101 101 115 102 99 94 94 92 100 
0 105 101 100 94 102 105 109 87 100 106 100 103 109 98 103 102 
0 96 91 100 96 103 92 102 109 101 107 102 106 105 113 122 111 
0 99 94 105 105 95 108 109 105 101 112 104 87 106 98 114 116 
0 102 99 108 89 83 112 84 97 100 106 112 102 98 106 103 103 
0 100 101 86 93 103 100 100 111 100 97 107 112 110 111 110 109 
0 101 105 92 93 99 84 100 101 102 89 100 94 101 110 108 110 
0 99 108 93 105 96 111 110 113 95 105 108 106 97 97 99 103 
0 93 105 92 96 102 104 111 104 104 117 112 101 99 104 104 111 
0 99 94 99 97 102 115 99 116 94 109 115 106 104 107 104 100 
0 93 112 105 100 97 110 101 108 107 104 105 114 107 107 106 117 
0 108 106 96 86 106 105 95 96 98 102 94 103 103 102 106 107 
0 94 108 98 99 111 111 106 119 107 106 99 104 91 100 110 105 
0 94 110 100 99 96 113 106 96 100 99 102 109 102 94 99 94 
0 93 99 112 99 93 106 107 109 99 94 106 102 95 102 97 97 
0 114 96 101 101 95 104 105 103 105 103 106 120 94 97 92 116 
0 90 97 96 98 103 105 103 92 93 103 102 95 109 100 97 95 
0 116 103 96 98 102 109 115 99 96 91 95 100 94 101 93 111 
0 99 100 99 105 96 105 96 120 94 102 104 103 102 96 103 107 
0 93 104 111 109 107 109 100 97 104 96 101 107 112 97 102 116 
0 101 87 96 95 99 100 94 111 114 95 99 99 94 96 103 106 
0 97 106 101 109 99 117 97 107 97 99 107 95 105 103 95 105 
0 94 111 105 101 99 107 101 96 106 109 98 105 90 105 110 107 
0 97 105 100 92 103 114 112 107 102 113 100 98 106 102 104 104 
0 100 105 92 86 99 103 101 107 99 108 109 107 108 110 114 106 
0 100 99 108 82 111 109 101 95 107 107 99 112 112 100 105 109 
