936 2 52 51 9 41 40 19 54 50 46 47 61 2 52 54 16 
996 0 39 39 1 47 26 30 55 51 23 43 55 2 47 47 16 
956 10 38 38 3 41 36 40 47 40 43 26 58 3 51 44 16 
892 13 46 46 7 46 25 46 65 57 59 41 38 6 61 50 24 
984 22 45 45 3 55 23 15 20 52 26 33 53 1 49 40 22 
1044 0 31 35 12 37 28 59 24 50 31 27 40 11 37 39 14 
1088 1 40 45 3 32 35 55 46 54 17 33 41 11 48 39 2 
924 12 48 31 7 49 49 41 46 35 33 55 38 5 60 56 25 
1004 3 39 37 10 47 37 30 46 46 63 43 35 20 44 47 12 
880 8 46 48 26 53 37 49 43 58 33 52 53 9 74 56 18 
896 2 64 58 10 60 20 35 57 31 57 23 46 29 48 68 26 
920 1 50 44 5 49 34 31 48 24 35 58 61 12 53 67 10 
1104 3 48 35 7 24 23 19 49 41 27 20 34 0 33 42 1 
948 4 47 64 25 37 51 28 68 45 46 47 42 5 55 62 10 
948 3 48 59 19 49 35 26 58 31 39 36 42 6 42 49 20 
1036 2 32 29 1 29 14 18 37 47 45 35 63 1 42 40 15 
828 18 59 38 14 46 57 56 64 56 40 46 69 13 61 59 5 
1104 1 46 33 2 21 42 12 28 37 33 34 46 9 32 34 10 
984 9 37 40 11 39 31 30 52 50 39 25 40 6 58 45 26 
960 3 53 47 14 40 47 23 53 49 52 28 37 5 51 41 17 
884 7 52 45 3 43 37 39 50 34 64 54 45 17 56 55 23 
872 25 54 53 15 59 49 37 63 50 38 41 51 22 51 52 8 
1100 3 52 58 7 44 18 18 47 38 25 43 45 5 43 43 12 
956 10 32 39 12 45 25 35 60 36 34 35 51 21 49 50 17 
996 6 55 62 14 33 34 29 44 47 44 34 46 9 40 30 12 
1016 11 26 35 14 41 33 33 20 45 36 50 48 12 47 39 4 
972 2 38 28 9 51 35 27 39 35 52 45 59 0 59 58 14 
820 14 51 32 26 50 48 61 74 58 52 53 60 35 65 70 36 
1052 1 42 54 4 33 35 34 42 49 37 29 47 14 46 45 16 
1004 3 56 35 2 38 35 42 64 42 40 35 51 17 53 58 9 
1052 2 26 34 3 29 40 50 46 34 32 29 43 3 49 43 9 
984 0 42 42 8 44 32 32 68 33 23 42 38 23 51 59 22 
1000 2 24 40 1 50 38 57 57 30 50 47 51 1 55 60 20 
1096 5 23 25 12 29 37 57 41 24 33 29 31 7 38 40 6 
1040 3 38 27 6 18 31 43 44 38 20 18 45 1 37 38 11 
920 20 47 50 3 61 56 39 59 58 58 32 58 11 48 57 15 
1032 2 44 35 0 31 46 13 53 62 40 49 35 11 49 47 0 
972 15 37 19 7 40 40 21 36 49 32 30 60 14 52 35 11 
1048 3 35 43 5 41 51 15 55 46 26 46 53 17 41 55 1 
988 13 59 50 12 34 37 26 32 31 35 39 49 0 39 36 12 
