336 1 0 2 3 
336 3 2 2 1 
356 3 1 0 0 
340 1 0 0 3 
360 3 0 2 0 
324 3 2 0 0 
344 3 3 1 0 
332 0 1 3 0 
336 2 2 0 2 
336 3 2 2 0 
332 0 2 0 1 
360 0 2 1 3 
340 3 0 3 0 
356 0 3 0 2 
332 1 2 2 3 
340 0 2 1 1 
328 0 0 2 0 
328 1 3 0 0 
372 0 3 1 2 
344 3 2 1 2 
