0 93 93 87 82 99 92 91 94 92 93 91 93 83 103 98 84 
0 96 92 78 82 92 90 92 84 84 90 86 88 87 93 102 94 
0 87 95 85 94 94 101 98 90 91 95 90 94 97 95 90 78 
0 104 95 101 93 84 99 90 97 83 94 88 96 80 83 78 88 
0 72 88 87 91 94 87 95 87 87 89 93 91 100 95 83 96 
0 83 90 90 74 91 95 88 97 87 97 87 102 85 97 96 91 
0 73 81 86 89 84 83 93 60 81 88 93 82 91 88 94 86 
0 100 97 92 107 87 94 96 89 91 95 102 82 95 104 85 95 
0 96 86 80 80 89 92 100 77 89 89 89 80 105 86 96 87 
0 95 96 76 86 85 92 79 86 101 94 96 88 81 83 101 87 
0 76 83 94 100 95 91 93 95 89 77 87 83 100 80 89 85 
0 83 95 102 95 83 79 94 92 93 97 91 93 94 80 97 95 
0 106 86 87 89 84 77 87 92 86 92 94 92 97 95 97 91 
0 93 84 87 62 93 84 80 84 83 86 85 91 85 81 88 87 
0 93 110 88 89 87 98 90 86 90 99 94 88 86 93 83 94 
0 85 93 78 85 91 86 78 94 93 97 92 88 85 104 83 90 
0 83 96 92 94 90 92 94 86 87 90 85 90 97 96 88 93 
0 95 92 88 92 95 90 105 84 89 95 93 85 95 90 99 85 
0 89 86 72 89 96 98 92 87 93 96 83 100 82 94 97 92 
0 77 93 96 94 74 87 92 102 75 83 82 96 90 95 103 98 
