1316 1 0 3 3 2 0 1 3 1 1 2 2 1 1 3 0 
1356 1 0 1 2 2 0 3 3 1 3 1 2 1 1 2 3 
1392 0 2 3 0 0 0 3 3 0 1 2 2 1 2 1 3 
1364 3 0 0 1 2 1 0 2 2 2 3 3 0 2 1 2 
1340 2 0 2 3 3 3 0 2 3 2 3 0 0 3 3 0 
1364 3 2 1 0 3 1 1 0 0 2 0 2 3 1 2 3 
1356 2 1 3 1 2 0 1 3 1 1 1 2 1 1 3 0 
1400 3 1 0 0 0 2 2 0 0 1 3 1 0 2 1 3 
1416 1 1 3 3 1 1 3 1 1 1 1 2 0 1 3 3 
1380 3 0 0 0 3 1 0 3 2 1 3 2 0 1 3 2 
1340 1 0 1 3 3 0 2 0 2 1 1 1 0 2 1 3 
1380 3 0 3 2 3 0 0 1 0 0 1 0 2 0 0 0 
1396 0 0 2 3 0 0 0 3 3 2 3 2 0 2 0 1 
1352 2 2 0 0 0 3 3 0 3 2 0 0 3 3 0 3 
1368 1 2 1 3 1 2 2 0 1 3 0 2 0 2 1 2 
1312 3 1 1 1 1 0 1 2 3 2 3 2 2 0 0 2 
1388 3 3 0 0 2 0 0 0 1 3 0 0 2 1 1 0 
1352 0 3 0 2 2 0 1 0 1 3 0 2 0 1 0 2 
1328 1 0 3 0 0 2 2 1 2 3 0 2 2 3 3 2 
1384 1 2 1 1 1 3 2 2 1 4 1 3 1 0 0 2 
1320 2 3 0 2 2 0 1 0 0 1 3 0 3 0 0 1 
1376 1 1 1 3 1 3 2 3 2 3 3 3 2 2 0 2 
1324 3 3 3 0 3 1 3 1 2 3 0 2 3 1 0 3 
1364 0 1 3 1 1 1 1 2 3 0 1 2 1 3 0 0 
1380 0 2 2 3 0 1 0 3 3 3 1 1 0 3 0 2 
1392 1 2 0 2 2 0 1 3 2 3 0 0 1 2 1 0 
1336 3 2 2 1 3 2 1 0 3 1 0 2 0 0 3 2 
1364 0 2 1 0 3 2 0 0 1 1 2 1 0 0 2 0 
1352 3 2 1 2 2 1 1 2 3 3 1 0 3 2 2 0 
1336 0 0 0 3 3 0 2 3 1 3 1 2 1 1 2 3 
1340 1 0 1 1 2 0 2 2 2 2 3 0 3 2 1 3 
1384 3 1 1 3 0 3 3 1 0 0 1 2 3 1 2 1 
1372 3 0 3 0 0 0 0 3 1 1 3 2 0 1 3 2 
1424 3 0 1 0 3 1 2 2 0 2 2 1 3 2 0 3 
1388 1 1 2 2 2 0 0 1 2 2 2 0 1 3 2 1 
1388 3 2 0 3 3 1 1 2 0 0 1 1 2 3 2 1 
1344 3 0 1 2 1 1 3 2 2 1 1 0 1 1 2 1 
1352 3 2 0 0 2 0 1 2 2 1 3 2 1 3 0 0 
1344 1 1 3 3 0 1 2 3 1 1 2 1 2 2 0 2 
1428 3 3 1 1 0 1 2 2 0 0 3 1 3 2 2 0 
