460 2 2 3 0 
464 2 2 3 0 
476 1 2 2 1 
424 0 1 2 3 
448 0 0 3 1 
472 2 0 0 1 
492 3 2 2 1 
448 1 3 0 1 
444 1 2 3 3 
432 3 2 3 1 
444 1 2 1 3 
460 0 1 2 2 
428 3 3 3 2 
496 0 0 1 3 
440 2 2 1 2 
428 1 3 1 0 
424 2 2 2 1 
440 1 1 1 0 
440 3 0 0 1 
472 2 3 0 0 
440 2 0 2 2 
444 1 1 0 0 
432 3 1 2 0 
460 0 3 1 2 
468 0 3 2 1 
468 3 1 3 2 
464 1 1 0 0 
460 1 1 3 2 
452 3 2 2 0 
480 0 0 3 1 
452 3 2 2 2 
452 0 2 1 2 
432 2 3 0 0 
488 0 1 1 3 
452 3 3 1 1 
484 3 3 2 0 
496 2 2 0 2 
440 3 1 0 1 
464 2 1 0 1 
460 1 0 3 3 
