1612 1 0 1 3 2 0 2 3 2 1 3 3 1 2 1 0 
1580 0 2 1 0 3 2 2 1 3 3 0 2 3 3 1 1 
1596 1 2 1 3 3 3 2 1 0 1 0 2 1 2 0 3 
1552 0 3 0 2 1 3 3 3 2 2 3 2 0 1 2 1 
1604 2 2 2 3 0 0 0 2 3 1 1 0 0 0 1 2 
1600 0 3 3 1 1 0 2 3 2 1 2 1 0 2 2 1 
1596 3 1 1 2 3 2 2 0 2 1 2 1 2 0 2 0 
1604 0 2 0 0 2 2 2 3 0 2 3 2 0 0 2 0 
1604 3 3 3 1 2 1 1 3 0 3 3 0 3 3 0 1 
1552 2 0 0 0 1 2 2 0 2 0 3 3 2 2 2 2 
1592 2 3 1 3 1 1 2 2 1 1 2 1 2 0 2 3 
1544 3 0 2 2 1 3 2 2 0 0 0 2 0 3 3 3 
1584 1 2 3 1 3 1 3 1 1 0 3 0 0 0 2 2 
1564 2 2 2 2 3 1 3 2 0 0 0 3 1 0 1 0 
1592 0 1 2 1 3 3 0 3 0 1 1 3 0 2 1 0 
1524 0 0 0 0 0 3 1 2 3 3 3 0 0 2 0 0 
1568 1 2 3 1 2 1 0 1 0 0 0 3 3 2 2 3 
1568 0 1 1 3 2 1 3 2 0 3 0 2 3 2 0 3 
1564 1 1 1 1 1 3 1 0 2 1 1 1 1 0 1 3 
1576 0 1 3 1 2 1 2 2 1 1 0 2 3 0 1 3 
1556 0 1 2 1 1 0 3 3 1 3 2 2 3 2 3 2 
1560 1 3 0 1 3 0 1 3 0 1 0 1 3 1 0 0 
1564 3 0 1 3 3 3 0 3 3 3 1 3 1 3 0 2 
1624 2 1 1 1 1 2 1 1 1 3 0 0 1 1 2 2 
1604 1 2 0 1 2 0 2 0 2 3 0 0 0 2 0 3 
1588 3 0 0 3 0 1 1 0 2 0 2 3 0 1 0 3 
1592 2 2 0 3 0 2 2 1 3 2 3 0 1 2 1 1 
1588 2 3 3 3 2 0 3 0 1 0 3 0 0 3 0 2 
1624 2 0 2 3 2 3 0 2 2 2 3 0 0 2 1 3 
1532 2 2 3 0 1 1 1 1 0 2 0 0 0 3 0 1 
1576 1 1 1 3 0 2 2 2 1 3 0 2 2 3 0 3 
1580 1 1 3 3 0 0 3 3 2 0 1 1 1 0 3 3 
1580 2 2 3 2 2 0 0 1 2 3 1 2 0 1 0 1 
1624 1 0 2 1 1 2 3 2 1 0 1 2 0 1 1 0 
1616 2 1 1 1 3 0 0 2 0 0 1 0 1 0 0 0 
1576 2 2 3 1 0 2 3 1 2 1 0 2 3 0 1 0 
1548 0 3 3 0 2 3 2 1 2 2 0 2 2 0 0 1 
1612 3 0 1 1 1 2 1 2 0 0 2 1 3 4 2 2 
1612 1 3 3 1 0 0 0 3 0 3 1 1 1 2 3 3 
1572 3 2 1 2 0 1 3 3 2 2 3 2 0 0 2 2 
