408 920 0 0 0 0 3 3 3 1 2 3 2 2 0 3 2 0 2 3 2 1 
408 960 0 0 0 0 0 0 0 1 1 0 2 3 1 3 2 2 3 2 1 0 
408 892 0 0 4 0 1 1 1 3 0 0 1 0 0 2 1 1 0 3 0 3 
404 932 0 0 0 0 2 2 2 3 1 2 0 3 1 3 1 2 2 1 3 0 
408 912 4 0 0 0 0 0 0 1 2 1 1 3 1 0 2 3 2 0 2 1 
408 908 0 0 0 0 1 3 0 3 1 3 3 1 3 0 3 2 1 0 0 3 
408 932 0 0 0 0 2 0 3 3 0 0 2 1 2 2 0 0 1 3 1 0 
408 944 0 0 0 0 2 0 3 2 0 2 3 0 0 2 2 0 1 2 1 1 
408 844 0 0 0 0 0 3 3 1 2 3 3 1 1 1 1 3 3 2 3 0 
408 948 0 0 0 0 2 0 0 1 2 3 1 1 0 2 1 3 1 3 1 0 
408 964 0 0 0 0 3 3 0 1 0 3 0 1 0 3 2 2 0 2 0 0 
408 924 0 0 0 0 2 2 3 1 0 1 2 1 3 3 0 2 2 0 1 0 
408 892 0 0 0 0 0 3 2 0 3 0 0 0 3 0 2 3 1 2 2 2 
408 924 0 0 0 0 1 1 1 0 3 1 0 1 2 0 1 1 1 0 2 3 
408 948 0 0 0 0 0 3 1 1 0 1 1 3 3 1 0 0 1 0 1 0 
408 904 0 0 0 0 0 2 1 2 0 0 0 0 0 2 0 2 2 0 0 0 
408 964 0 0 4 0 3 1 0 2 0 2 2 2 2 1 1 3 2 2 2 2 
408 904 0 0 0 0 2 2 3 1 1 2 2 1 2 2 2 1 2 3 0 2 
408 936 0 0 4 0 2 2 1 3 2 3 2 3 1 3 1 0 0 0 0 0 
408 932 0 0 0 0 2 3 0 3 3 2 2 2 0 1 1 2 1 1 3 0 
