1500 32 4 12 20 1 2 2 3 0 1 2 1 3 0 2 0 1 0 2 0 
1492 12 36 20 20 2 0 1 0 2 0 1 2 3 1 3 1 2 1 3 1 
1484 4 56 12 12 3 1 3 1 2 0 3 1 1 3 2 2 3 0 2 1 
1496 0 0 32 24 1 3 3 0 3 1 2 0 2 0 3 3 2 3 1 1 
1488 0 20 16 12 2 2 0 3 3 1 0 0 2 0 2 3 0 2 3 1 
1484 4 8 20 0 2 2 0 2 0 0 2 3 1 1 3 2 3 2 2 1 
1488 24 12 20 0 1 0 0 2 2 1 1 3 1 1 1 0 1 2 0 3 
1504 12 0 12 16 3 0 3 1 0 2 3 1 0 0 3 2 3 0 3 1 
1460 20 16 4 16 3 2 1 1 3 2 1 3 2 1 3 0 3 2 2 1 
1512 20 16 24 24 2 1 0 2 0 3 1 0 3 1 3 2 2 1 1 1 
1500 16 20 4 8 2 2 1 0 1 1 1 2 0 2 0 3 1 0 2 0 
1512 20 20 28 12 3 2 2 3 1 3 2 2 2 1 1 0 2 3 1 2 
1516 28 40 36 20 3 0 0 1 3 0 2 3 2 1 2 2 0 3 3 0 
1496 12 16 24 20 0 3 2 0 1 3 2 3 0 1 0 1 0 2 3 1 
1484 16 16 4 16 2 3 1 0 3 1 1 3 1 0 2 3 2 2 3 2 
1484 8 0 8 12 3 1 3 3 0 0 0 0 3 2 2 2 3 0 0 3 
1516 32 16 24 20 2 0 1 1 3 2 2 1 1 0 1 0 1 2 2 2 
1508 8 28 12 48 0 3 2 2 0 1 0 2 0 1 1 1 3 3 1 3 
1504 16 8 12 24 0 0 2 1 3 1 3 2 0 2 2 0 0 3 1 2 
1500 8 8 28 32 3 0 1 0 0 1 1 2 0 3 0 0 2 1 1 2 
