460 1 1 1 1 
444 2 1 2 0 
436 1 3 1 2 
464 1 1 3 0 
468 3 1 3 3 
440 1 1 3 1 
468 3 2 3 1 
460 2 3 1 1 
448 1 1 3 2 
460 2 0 2 1 
476 1 0 0 1 
428 2 3 3 3 
460 1 2 2 3 
456 0 1 1 1 
424 1 3 1 2 
480 1 0 2 0 
464 2 1 1 3 
408 3 0 3 3 
432 0 1 3 3 
416 3 3 2 0 
